//MAP CONVERTED BY dmm2tgm.py THIS HEADER COMMENT PREVENTS RECONVERSION, DO NOT REMOVE
"a" = (
)
"c" = (
/turf/simulated/floor/carpet/blue,
/area/centcom)
"d" = (
/obj/map_effect/portal/master/side_b{
	dir = 1
	},
/turf/simulated/floor/carpet/blue,
/area/centcom)
"f" = (
/obj/map_effect/portal/line/side_b{
	dir = 1
	},
/turf/simulated/floor/carpet/blue,
/area/centcom)
"i" = (
/turf/simulated/floor/wood,
/area/centcom)
"j" = (
/turf/space,
/area/space)
"m" = (
/obj/map_effect/portal/master/side_a,
/turf/simulated/floor/carpet,
/area/centcom)
"n" = (
/obj/map_effect/portal/line/side_a,
/turf/simulated/floor/carpet,
/area/centcom)
"p" = (
/obj/map_effect/portal/master/side_a{
	dir = 4;
	portal_id = "horizontal"
	},
/turf/simulated/floor/wood,
/area/centcom)
"r" = (
/turf/simulated/floor/carpet,
/area/centcom)
"E" = (
/obj/map_effect/portal/master/side_b{
	dir = 8;
	portal_id = "horizontal"
	},
/turf/simulated/floor/wood,
/area/centcom)
"G" = (
/obj/map_effect/portal/line/side_a{
	dir = 4
	},
/turf/simulated/floor/wood,
/area/centcom)
"L" = (
/obj/map_effect/portal/line/side_b{
	dir = 8
	},
/turf/simulated/floor/wood,
/area/centcom)
"N" = (
/turf/simulated/wall/concrete,
/area/centcom)
"V" = (
/turf/simulated/floor/tiled/techmaint,
/area/centcom)

(1,1,1) = {"
j
j
j
j
j
j
j
j
j
j
j
j
j
j
j
j
j
j
j
j
j
j
j
j
j
j
j
j
j
a
"}
(2,1,1) = {"
j
j
j
j
j
j
j
j
j
j
j
j
j
j
j
j
j
j
j
j
j
j
j
j
j
j
j
j
j
j
"}
(3,1,1) = {"
j
j
j
j
j
j
j
j
j
j
j
j
j
j
j
j
j
j
j
j
j
j
j
j
j
j
j
j
j
j
"}
(4,1,1) = {"
j
j
j
j
j
j
j
N
N
N
N
N
j
j
j
j
j
j
j
j
j
j
j
N
N
N
N
N
j
j
"}
(5,1,1) = {"
j
j
j
j
j
j
j
N
V
V
V
N
j
j
j
j
j
j
j
j
j
j
j
N
p
G
G
N
j
j
"}
(6,1,1) = {"
j
j
j
j
j
j
j
N
V
V
V
N
j
j
j
j
j
j
j
j
j
j
j
N
i
i
i
N
j
j
"}
(7,1,1) = {"
j
j
j
j
j
j
j
N
V
V
V
N
j
j
j
j
j
j
j
j
j
j
N
N
i
i
i
N
j
j
"}
(8,1,1) = {"
j
j
j
j
j
j
j
N
V
V
V
N
j
j
j
j
j
j
j
j
j
j
N
i
i
i
i
N
j
j
"}
(9,1,1) = {"
j
j
j
j
j
j
j
N
V
V
V
N
j
j
j
j
j
j
j
j
j
j
N
N
i
i
i
N
j
j
"}
(10,1,1) = {"
j
j
j
j
j
j
j
N
V
V
V
N
N
j
j
j
j
j
j
j
j
j
j
N
i
i
i
N
j
j
"}
(11,1,1) = {"
j
j
j
j
j
j
j
N
V
V
V
V
N
j
j
j
j
j
j
j
j
j
j
N
i
i
i
N
j
j
"}
(12,1,1) = {"
j
j
j
j
j
j
j
N
V
V
V
N
N
j
j
j
j
j
j
j
j
j
j
N
i
i
i
N
j
j
"}
(13,1,1) = {"
j
j
j
j
j
j
j
N
V
V
V
N
j
j
j
j
j
j
j
j
j
j
j
N
i
i
i
N
j
j
"}
(14,1,1) = {"
j
j
j
j
j
j
j
N
V
V
V
N
j
j
j
j
j
j
j
j
j
j
j
N
i
i
i
N
j
j
"}
(15,1,1) = {"
j
j
j
j
j
j
j
N
V
V
V
N
N
N
N
j
j
j
j
j
j
j
N
N
i
i
i
N
j
j
"}
(16,1,1) = {"
j
j
j
j
j
j
j
N
c
c
c
c
c
d
N
j
j
j
j
j
j
j
N
m
r
r
r
N
j
j
"}
(17,1,1) = {"
j
j
j
j
j
j
j
N
c
c
c
c
c
f
N
j
j
j
j
j
j
j
N
n
r
r
r
N
j
j
"}
(18,1,1) = {"
j
j
j
j
j
j
j
N
c
c
c
c
c
f
N
j
j
j
j
j
j
j
N
n
r
r
r
N
j
j
"}
(19,1,1) = {"
j
j
j
j
j
j
j
N
N
N
N
N
N
N
N
j
j
j
j
j
j
j
N
N
i
i
i
N
j
j
"}
(20,1,1) = {"
j
j
j
j
j
j
j
j
j
j
j
j
j
j
j
j
j
j
j
j
j
j
j
N
i
i
i
N
j
j
"}
(21,1,1) = {"
j
j
j
j
j
j
j
j
j
j
j
j
j
j
j
j
j
j
j
j
j
j
j
N
i
i
i
N
j
j
"}
(22,1,1) = {"
j
j
j
j
j
j
j
j
j
j
j
j
j
j
j
j
j
j
j
j
j
j
j
N
i
i
i
N
j
j
"}
(23,1,1) = {"
j
j
j
j
j
j
j
j
j
j
j
j
j
j
j
j
j
j
j
j
j
j
j
N
i
i
i
N
j
j
"}
(24,1,1) = {"
j
j
j
j
j
j
j
j
j
j
j
j
j
j
j
j
j
j
j
j
j
j
j
N
i
i
i
N
j
j
"}
(25,1,1) = {"
j
j
j
j
j
j
j
j
j
j
j
j
j
j
j
j
j
j
j
j
j
j
j
N
i
i
i
N
j
j
"}
(26,1,1) = {"
j
j
j
j
j
j
j
j
j
j
j
j
j
j
j
j
j
j
j
j
j
j
j
N
i
i
i
N
j
j
"}
(27,1,1) = {"
j
j
j
j
j
j
j
j
j
j
j
j
j
j
j
j
j
j
j
j
j
j
j
N
i
i
i
N
j
j
"}
(28,1,1) = {"
j
j
j
j
j
j
j
j
j
j
j
j
j
j
j
j
j
j
j
j
j
j
j
N
i
i
i
N
j
j
"}
(29,1,1) = {"
j
j
j
j
j
j
j
j
j
j
j
j
j
j
j
j
j
j
j
j
j
j
j
N
E
L
L
N
j
j
"}
(30,1,1) = {"
j
j
j
j
j
j
j
j
j
j
j
j
j
j
j
j
j
j
j
j
j
j
j
N
N
N
N
N
j
j
"}
(31,1,1) = {"
j
j
j
j
j
j
j
j
j
j
j
j
j
j
j
j
j
j
j
j
j
j
j
j
j
j
j
j
j
j
"}
(32,1,1) = {"
j
j
j
j
j
j
j
j
j
j
j
j
j
j
j
j
j
j
j
j
j
j
j
j
j
j
j
j
j
j
"}
(33,1,1) = {"
j
j
j
j
j
j
j
j
j
j
j
j
j
j
j
j
j
j
j
j
j
j
j
j
j
j
j
j
j
j
"}
(34,1,1) = {"
j
j
j
j
j
j
j
j
j
j
j
j
j
j
j
j
j
j
j
j
j
j
j
j
j
j
j
j
j
j
"}
(35,1,1) = {"
j
j
j
j
j
j
j
j
j
j
j
j
j
j
j
j
j
j
j
j
j
j
j
j
j
j
j
j
j
j
"}
