"aI" = (/obj/item/ammo_magazine/rifle{initial_ammo = 0},/obj/decal/cleanable/dirt,/turf/simulated/floor/asteroid{initial_gas = list("oxygen" = 21.8366, "nitrogen" = 82.1472)},/area/template_noop)
"bi" = (/obj/structure/table/steel_reinforced,/obj/random/snack,/obj/decal/cleanable/dirt,/turf/simulated/floor/tiled/monotile,/area/template_noop)
"bQ" = (/obj/effect{icon = 'icons/fd/vls.dmi'; icon_state = "loader"; mouse_opacity = 0; name = "VLS"},/turf/simulated/floor/exoplanet/concrete/reinforced,/area/template_noop)
"bS" = (/obj/item/ammo_casing/rifle/used{dir = 1; pixel_x = 9; pixel_y = -6},/obj/decal/cleanable/dirt,/turf/simulated/floor/asteroid{initial_gas = list("oxygen" = 21.8366, "nitrogen" = 82.1472)},/area/template_noop)
"cg" = (/obj/item/ammo_casing/shotgun/flechette{icon_state = "slshell-spent"; pixel_y = 11},/obj/decal/cleanable/dirt,/turf/simulated/floor/asteroid{initial_gas = list("oxygen" = 21.8366, "nitrogen" = 82.1472)},/area/template_noop)
"cy" = (/obj/decal/cleanable/dirt,/obj/floor_decal/industrial/warning{dir = 8},/turf/simulated/floor/exoplanet/concrete/reinforced,/area/template_noop)
"cH" = (/obj/random/junk,/turf/simulated/floor/exoplanet/concrete/reinforced/road,/area/template_noop)
"dR" = (/obj/item/ammo_casing/pistol/used,/obj/item/ammo_casing/pistol/used{dir = 1; pixel_x = -5; pixel_y = -5},/obj/decal/cleanable/dirt,/turf/simulated/floor/tiled/steel_grid,/area/template_noop)
"ef" = (/obj/decal/cleanable/dirt,/turf/simulated/floor/exoplanet/concrete,/area/template_noop)
"eu" = (/obj/item/ammo_casing/rifle/used{dir = 4; pixel_y = 15},/obj/decal/cleanable/dirt,/turf/simulated/floor/asteroid{initial_gas = list("oxygen" = 21.8366, "nitrogen" = 82.1472)},/area/template_noop)
"eN" = (/obj/decal/cleanable/dirt,/obj/floor_decal/industrial/warning{dir = 1},/turf/simulated/floor/exoplanet/concrete/reinforced,/area/template_noop)
"eW" = (/obj/decal/cleanable/dirt,/turf/simulated/floor/exoplanet/concrete/reinforced,/area/template_noop)
"fl" = (/obj/floor_decal/industrial/warning{dir = 4},/turf/simulated/floor/exoplanet/concrete/reinforced,/area/template_noop)
"gl" = (/obj/random/trash,/turf/simulated/floor/exoplanet/concrete/reinforced/road,/area/template_noop)
"gp" = (/obj/item/ammo_casing/rifle/used,/obj/item/ammo_casing/rifle/used{dir = 4; pixel_y = 15},/obj/item/ammo_casing/rifle/used{dir = 8; pixel_x = -6; pixel_y = -4},/obj/item/material/shard,/turf/simulated/floor/asteroid{initial_gas = list("oxygen" = 21.8366, "nitrogen" = 82.1472)},/area/template_noop)
"hr" = (/obj/random/trash,/obj/floor_decal/industrial/warning{dir = 4},/turf/simulated/floor/exoplanet/concrete/reinforced,/area/template_noop)
"hv" = (/turf/template_noop,/area/template_noop)
"ia" = (/obj/decal/cleanable/dirt,/turf/simulated/floor/exoplanet/concrete/reinforced/road,/area/template_noop)
"iG" = (/obj/effect{icon = 'icons/obj/structures.dmi'; icon_state = "ladder10"; mouse_opacity = 0; name = "ladder"; pixel_y = 32},/obj/effect{icon = 'icons/obj/structures.dmi'; icon_state = "ladder10"; mouse_opacity = 0; name = "ladder"; pixel_y = 12},/obj/floor_decal/corner/red/mono,/turf/simulated/floor/tiled/dark/monotile,/area/template_noop)
"iI" = (/obj/floor_decal/industrial/warning{dir = 8},/turf/simulated/floor/exoplanet/concrete/reinforced,/area/template_noop)
"iW" = (/obj/landmark/scorcher,/turf/simulated/floor/exoplanet/concrete/reinforced,/area/template_noop)
"jh" = (/turf/simulated/wall/concrete,/area/template_noop)
"jo" = (/obj/machinery/door/unpowered/simple/iron,/obj/decal/cleanable/dirt,/turf/simulated/floor/tiled/dark/monotile,/area/template_noop)
"kk" = (/obj/effect{icon = 'icons/fd/vls.dmi'; icon_state = "loader"; mouse_opacity = 0; name = "VLS"},/obj/effect{icon = 'icons/fd/vls.dmi'; icon_state = "vls"; layer = 3.1; mouse_opacity = 0; name = "VLS"},/turf/simulated/floor/exoplanet/concrete/reinforced,/area/template_noop)
"kq" = (/obj/random/junk,/obj/decal/cleanable/dirt,/turf/simulated/floor/asteroid{initial_gas = list("oxygen" = 21.8366, "nitrogen" = 82.1472)},/area/template_noop)
"kO" = (/obj/structure/table/steel_reinforced,/obj/random/loot,/obj/decal/cleanable/dirt,/turf/simulated/floor/tiled/monotile,/area/template_noop)
"lj" = (/obj/decal/cleanable/dirt,/turf/template_noop,/area/template_noop)
"lr" = (/obj/structure/table/steel_reinforced,/obj/item/ammo_magazine/box/pistol{max_ammo = 45; pixel_y = 8},/obj/decal/cleanable/dirt,/turf/simulated/floor/tiled/monotile,/area/template_noop)
"mD" = (/obj/random/loot,/obj/decal/cleanable/dirt,/turf/simulated/floor/asteroid{initial_gas = list("oxygen" = 21.8366, "nitrogen" = 82.1472)},/area/template_noop)
"mX" = (/obj/random/trash,/obj/decal/cleanable/dirt,/turf/simulated/floor/asteroid{initial_gas = list("oxygen" = 21.8366, "nitrogen" = 82.1472)},/area/template_noop)
"pe" = (/obj/floor_decal/corner/red{dir = 6},/turf/simulated/floor/tiled/dark,/area/template_noop)
"px" = (/obj/decal/cleanable/dirt,/obj/floor_decal/corner/red{dir = 9},/turf/simulated/floor/tiled,/area/template_noop)
"qI" = (/obj/item/plastique{timer = 1},/obj/decal/cleanable/dirt,/obj/decal/cleanable/dirt,/turf/simulated/floor/tiled/dark,/area/template_noop)
"rN" = (/obj/decal/cleanable/dirt,/obj/floor_decal/industrial/warning/corner{dir = 1},/turf/simulated/floor/exoplanet/concrete,/area/template_noop)
"sM" = (/obj/effect{icon = 'icons/obj/structures.dmi'; icon_state = "ladder01"; mouse_opacity = 0; name = "ladder"; pixel_y = 16},/obj/floor_decal/corner/red/mono,/turf/simulated/floor/tiled/dark/monotile,/area/template_noop)
"sQ" = (/obj/random/trash,/obj/decal/cleanable/dirt,/obj/decal/cleanable/dirt,/turf/simulated/floor/tiled/dark,/area/template_noop)
"tM" = (/obj/landmark/scorcher,/turf/simulated/floor/exoplanet/concrete,/area/template_noop)
"tZ" = (/obj/machinery/light/small{dir = 8},/obj/floor_decal/corner/red{dir = 9},/turf/simulated/floor/tiled/dark,/area/template_noop)
"ug" = (/obj/landmark/scorcher,/obj/decal/cleanable/dirt,/turf/simulated/floor/exoplanet/concrete/reinforced,/area/template_noop)
"uM" = (/obj/item/material/shard,/turf/simulated/floor/asteroid{initial_gas = list("oxygen" = 21.8366, "nitrogen" = 82.1472)},/area/template_noop)
"wh" = (/obj/decal/cleanable/dirt,/obj/floor_decal/industrial/warning/corner,/turf/simulated/floor/exoplanet/concrete,/area/template_noop)
"wE" = (/obj/decal/cleanable/dirt,/turf/simulated/floor/tiled/dark,/area/template_noop)
"wQ" = (/obj/decal/cleanable/blood/splatter,/obj/item/ammo_casing/pistol/used{dir = 4; pixel_x = 6; pixel_y = -7},/obj/decal/cleanable/dirt,/turf/simulated/floor/tiled/steel_grid,/area/template_noop)
"xo" = (/obj/landmark/clear,/obj/decal/cleanable/dirt,/obj/decal/cleanable/dirt,/turf/template_noop,/area/template_noop)
"xF" = (/obj/structure/curtain/open/bed,/obj/decal/cleanable/dirt,/turf/simulated/floor/tiled/monotile,/area/template_noop)
"xI" = (/turf/simulated/floor/asteroid{initial_gas = list("oxygen" = 21.8366, "nitrogen" = 82.1472)},/area/template_noop)
"xK" = (/obj/machinery/computer/modular/preset/security,/turf/simulated/floor/tiled,/area/template_noop)
"xO" = (/obj/structure/table/steel_reinforced,/obj/machinery/light/small{dir = 4},/obj/random/tool,/obj/floor_decal/corner/red{dir = 6},/turf/simulated/floor/tiled/dark,/area/template_noop)
"xY" = (/obj/random/trash,/turf/simulated/floor/asteroid{initial_gas = list("oxygen" = 21.8366, "nitrogen" = 82.1472)},/area/template_noop)
"yF" = (/obj/landmark/scorcher,/obj/decal/cleanable/dirt,/turf/simulated/floor/exoplanet/concrete/reinforced/road,/area/template_noop)
"zP" = (/obj/decal/cleanable/dirt,/obj/floor_decal/industrial/warning,/turf/simulated/floor/exoplanet/concrete/reinforced,/area/template_noop)
"zZ" = (/obj/item/ammo_casing/pistol/used{dir = 8; pixel_x = 2; pixel_y = 12},/obj/decal/cleanable/dirt,/turf/simulated/floor/tiled,/area/template_noop)
"Ao" = (/obj/random/junk,/turf/simulated/floor/asteroid{initial_gas = list("oxygen" = 21.8366, "nitrogen" = 82.1472)},/area/template_noop)
"Av" = (/obj/item/ammo_casing/rifle/used,/turf/simulated/floor/asteroid{initial_gas = list("oxygen" = 21.8366, "nitrogen" = 82.1472)},/area/template_noop)
"AX" = (/obj/structure/closet,/obj/random/loot,/obj/random/storage,/obj/random/tool,/obj/floor_decal/corner/red{dir = 9},/turf/simulated/floor/tiled/dark,/area/template_noop)
"AZ" = (/turf/simulated/floor/tiled/dark,/area/template_noop)
"BG" = (/obj/machinery/light/small,/obj/decal/cleanable/dirt,/obj/decal/cleanable/dirt,/turf/simulated/floor/tiled/dark,/area/template_noop)
"Dz" = (/obj/structure/wall_frame,/obj/item/material/shard,/turf/simulated/floor/plating,/area/template_noop)
"DM" = (/obj/random/loot,/turf/simulated/floor/exoplanet/concrete,/area/template_noop)
"EK" = (/obj/item/ammo_casing/rifle/used{dir = 1; pixel_x = 9; pixel_y = -6},/obj/landmark/clear,/obj/decal/cleanable/dirt,/turf/template_noop,/area/template_noop)
"EO" = (/obj/decal/cleanable/dirt,/turf/simulated/floor/asteroid{initial_gas = list("oxygen" = 21.8366, "nitrogen" = 82.1472)},/area/template_noop)
"EW" = (/obj/landmark/clear,/obj/decal/cleanable/dirt,/turf/template_noop,/area/template_noop)
"Fa" = (/obj/item/material/shard,/obj/decal/cleanable/dirt,/turf/simulated/floor/tiled,/area/template_noop)
"FZ" = (/obj/item/ammo_casing/rifle/used{dir = 8; pixel_x = -6; pixel_y = -4},/obj/decal/cleanable/dirt,/turf/simulated/floor/asteroid{initial_gas = list("oxygen" = 21.8366, "nitrogen" = 82.1472)},/area/template_noop)
"GG" = (/obj/item/ammo_casing/shotgun/flechette{icon_state = "slshell-spent"},/obj/decal/cleanable/dirt,/turf/simulated/floor/asteroid{initial_gas = list("oxygen" = 21.8366, "nitrogen" = 82.1472)},/area/template_noop)
"HB" = (/obj/random/junk,/obj/decal/cleanable/dirt,/turf/simulated/floor/exoplanet/concrete/reinforced,/area/template_noop)
"HE" = (/obj/landmark/scorcher,/turf/simulated/floor/exoplanet/concrete/reinforced/road,/area/template_noop)
"HF" = (/obj/effect{icon = 'icons/fd/vls.dmi'; icon_state = "loader"; mouse_opacity = 0; name = "VLS"},/obj/effect{icon = 'icons/fd/vls.dmi'; icon_state = "vls_closed"; layer = 3.1; mouse_opacity = 0; name = "VLS"},/turf/simulated/floor/exoplanet/concrete/reinforced,/area/template_noop)
"Ia" = (/obj/decal/cleanable/dirt,/obj/decal/cleanable/dirt,/obj/decal/cleanable/dirt,/obj/decal/cleanable/dirt,/turf/simulated/floor/exoplanet/concrete,/area/template_noop)
"IH" = (/turf/simulated/floor/exoplanet/concrete/reinforced/road,/area/template_noop)
"IP" = (/turf/unsimulated/mineral{name = "stone blockage"},/area/template_noop)
"IS" = (/obj/structure/hygiene/toilet{dir = 8},/obj/machinery/light/small{dir = 1},/obj/decal/cleanable/dirt,/turf/simulated/floor/tiled/dark,/area/template_noop)
"Ji" = (/obj/machinery/door/unpowered/simple/iron,/turf/simulated/floor/tiled/steel_ridged,/area/template_noop)
"JP" = (/obj/decal/cleanable/dirt,/obj/decal/cleanable/dirt,/obj/decal/cleanable/dirt,/obj/decal/cleanable/dirt,/obj/decal/cleanable/dirt,/obj/decal/cleanable/dirt,/obj/decal/cleanable/dirt,/turf/simulated/floor/exoplanet/concrete,/area/template_noop)
"Kk" = (/obj/machinery/light/small{dir = 1},/obj/decal/cleanable/dirt,/turf/simulated/floor/tiled,/area/template_noop)
"Kp" = (/obj/decal/cleanable/dirt,/obj/decal/cleanable/dirt,/turf/simulated/floor/tiled/dark/monotile,/area/template_noop)
"KT" = (/obj/decal/cleanable/dirt,/obj/decal/cleanable/dirt,/obj/decal/cleanable/dirt,/obj/decal/cleanable/dirt,/turf/simulated/floor/asteroid{initial_gas = list("oxygen" = 21.8366, "nitrogen" = 82.1472)},/area/template_noop)
"Lb" = (/obj/decal/cleanable/blood/splatter,/obj/decal/cleanable/dirt,/turf/simulated/floor/asteroid{initial_gas = list("oxygen" = 21.8366, "nitrogen" = 82.1472)},/area/template_noop)
"Mg" = (/obj/structure/closet,/obj/random/loot,/obj/random/snack,/obj/decal/cleanable/dirt,/obj/floor_decal/corner/red{dir = 9},/turf/simulated/floor/tiled,/area/template_noop)
"Na" = (/obj/effect{icon = 'icons/fd/vls.dmi'; icon_state = "loader_closed"; mouse_opacity = 0; name = "VLS"},/turf/simulated/floor/exoplanet/concrete/reinforced,/area/template_noop)
"Nj" = (/obj/structure/table/steel_reinforced,/obj/random/toolbox,/turf/simulated/floor/tiled/monotile,/area/template_noop)
"Nq" = (/obj/floor_decal/industrial/warning,/turf/simulated/floor/exoplanet/concrete/reinforced,/area/template_noop)
"NI" = (/turf/simulated/floor/exoplanet/concrete,/area/template_noop)
"Os" = (/obj/landmark/scorcher,/obj/decal/cleanable/dirt,/turf/simulated/floor/exoplanet/concrete,/area/template_noop)
"Pk" = (/obj/random/trash,/turf/simulated/floor/exoplanet/concrete,/area/template_noop)
"PM" = (/obj/random/trash,/turf/simulated/floor/tiled/dark,/area/template_noop)
"Qh" = (/obj/structure/table/steel_reinforced,/obj/random/tech_supply,/obj/floor_decal/corner/red{dir = 6},/turf/simulated/floor/tiled/dark,/area/template_noop)
"QR" = (/obj/random/trash,/obj/floor_decal/industrial/warning,/turf/simulated/floor/exoplanet/concrete/reinforced,/area/template_noop)
"Rt" = (/obj/structure/bed/padded,/obj/machinery/light/small{dir = 1},/obj/random/loot,/obj/random/plushie,/obj/decal/cleanable/dirt,/turf/simulated/floor/tiled,/area/template_noop)
"Sp" = (/turf/simulated/floor/tiled/dark/monotile,/area/template_noop)
"Sr" = (/obj/landmark/damager,/turf/simulated/wall/concrete,/area/template_noop)
"SB" = (/obj/item/ammo_casing/rifle/used,/obj/decal/cleanable/dirt,/turf/simulated/floor/exoplanet/concrete,/area/template_noop)
"Tm" = (/obj/random/trash,/obj/decal/cleanable/dirt,/turf/simulated/floor/exoplanet/concrete/reinforced/road,/area/template_noop)
"Ts" = (/obj/decal/cleanable/dirt,/obj/floor_decal/industrial/warning/corner{dir = 4},/turf/simulated/floor/exoplanet/concrete,/area/template_noop)
"TA" = (/obj/floor_decal/industrial/warning/corner{dir = 8},/turf/simulated/floor/exoplanet/concrete,/area/template_noop)
"Wn" = (/obj/decal/cleanable/dirt,/obj/decal/cleanable/dirt,/obj/decal/cleanable/dirt,/turf/simulated/floor/asteroid{initial_gas = list("oxygen" = 21.8366, "nitrogen" = 82.1472)},/area/template_noop)
"Wy" = (/obj/random/tool,/obj/floor_decal/industrial/warning{dir = 4},/turf/simulated/floor/exoplanet/concrete/reinforced,/area/template_noop)
"WT" = (/obj/structure/table/steel_reinforced,/obj/decal/cleanable/dirt,/turf/simulated/floor/tiled/monotile,/area/template_noop)
"Xg" = (/obj/floor_decal/industrial/warning{dir = 1},/turf/simulated/floor/exoplanet/concrete/reinforced,/area/template_noop)
"XE" = (/obj/random/junk,/turf/simulated/floor/exoplanet/concrete/reinforced,/area/template_noop)
"XL" = (/obj/wallframe_spawn/no_grille,/turf/simulated/floor/plating,/area/template_noop)
"Yg" = (/obj/landmark/scorcher,/turf/simulated/floor/asteroid{initial_gas = list("oxygen" = 21.8366, "nitrogen" = 82.1472)},/area/template_noop)
"Yr" = (/obj/floor_decal/corner/red{dir = 9},/turf/simulated/floor/tiled/dark,/area/template_noop)
"Zw" = (/obj/structure/bed/chair/office/comfy/red,/obj/decal/cleanable/dirt,/turf/simulated/floor/tiled/steel_grid,/area/template_noop)
"Zz" = (/obj/landmark/clear,/turf/template_noop,/area/template_noop)

(1,1,1) = {"
hvhvhvhvhvSrjhjhjhjhSrhvhvhvhvhvhvhvhvhvhvhvhvhvhvhvhvYgxIhv
hvhvhvhvxIjhiGAZAZsMSrZzxIhvhvhvhvhvhvhvhvhvhvhvhvxIhviWcHhv
hvxIxIxIxIjhtZAZPMpeSrxIZzZzjhSrSrSrjhjhSrSrSrhvZzHEhvglHExI
hvxIxIxIhvSrYrPMAZxOSrZzxIZzjoISjhMgzZKkxKkOjhZzxIIHHEiaZzxI
hvxIxIhvhvSrAXAZAZQhjhxIEOxIjhjhjhpxwQdRZwWTXLZzZzeWiayFZzNI
hvxIhvhvxISrjhSpSpjhjhEOAoZzSrRtxFpxFalrbiNjXLZzNIyFZzugxIhv
hvxIxIxIZzZzxIxIZzZzEOEOZzZzSrSrjhJiDzXLXLjhSrZzefAoiaTmIHxI
hvhvxIxIZzxIxIZzxIxIZzEWxIxIZzZzxIuMEOEOZzZzZzZzNIEOiaZzHEOs
SrSrSrjhjhSrSrxIxYEOEWEOZzZzZzxIxYxILbEOtMNIZztMIHEWyFIHZzef
SrIPIPIPIPwEKpEOEWEOxIEOZzGGZzEOEOkqGGgpxIIHIHHEglEWeWIHxIef
SrIPIPIPIPqIKpKTEOAoEOZzEWxIAvLbEOaIWnEOkqxIxIIHHEiaiaZzXEOs
jhIPIPIPBGsQSpxIZzxIEOEOeuEWxImXxIEOFZxIeftMNIhvTmYgIHiayFtM
jhSrSrSrjhjhjhZzxIxIEWxIEWFZxIxIeuEOEOmDEWZzZzNIEOiayFeWiahv
hvhvxIZzxIxIZzxIxIEWEObSEOcgEKxIAoSBefNIefefEWEWefiaHEEOHExI
hvhvAoEOEWEWEWxIEWEOEOEWxoxoxIZzJPwhzPQRNqTAefEWOsxIiaiaIHxI
hvxIEOEOEOxYEOEWEWxImXEOxoEOxIZzIaflNaNaNacyefZzxIiayFIHTmtM
NININIEODMNINIZzNININIEOefNIPkxIefWyNaNaNaiIefZzxIIHHBiayFxI
NIHFNIEWefkkNIZzNIkkNIEONIkkNIAoefhrbQbQNaiIefZzZzxIyFiayFhv
NININIxIefNINIEWefefefEOefNINIZzefTseNXgeNrNNIhvZzxIIHeWeWhv
hvhvhvhvhvhvxIxIhvxIxIhvljljhvhvZzNINIefefefZzhvhvhvxIyFhvhv
"}
