"ai" = (/obj/floor_decal/corner/yellow{dir = 6},/obj/decal/cleanable/dirt,/obj/decal/cleanable/dirt,/turf/simulated/floor/tiled,/area/map_template/build/build19)
"aE" = (/obj/floor_decal/corner/yellow{dir = 6},/obj/random/trash,/obj/decal/cleanable/dirt,/obj/decal/cleanable/dirt,/turf/simulated/floor/tiled,/area/map_template/build/build19)
"aQ" = (/obj/decal/cleanable/dirt,/turf/simulated/floor/exoplanet/concrete/reinforced/road,/area/template_noop)
"bc" = (/obj/structure/largecrate,/obj/random/hardsuit{spawn_nothing_percentage = 90},/obj/machinery/light/small,/turf/simulated/floor/tiled/techfloor/grid,/area/map_template/build/build19)
"bK" = (/turf/simulated/floor/tiled/steel_grid,/area/map_template/build/build19)
"cR" = (/obj/floor_decal/industrial/warning,/obj/floor_decal/corner/yellow/border{dir = 1},/obj/decal/cleanable/dirt,/turf/simulated/floor/tiled/monotile,/area/map_template/build/build19)
"cU" = (/obj/structure/table/steel_reinforced,/obj/floor_decal/corner/yellow/border{dir = 4},/obj/random/snack,/obj/decal/cleanable/dirt,/turf/simulated/floor/tiled,/area/map_template/build/build19)
"da" = (/obj/structure/cable{d1 = 1; d2 = 8; icon_state = "1-8"},/obj/structure/cable{d1 = 1; d2 = 2; icon_state = "1-2"},/obj/random/trash,/turf/simulated/floor/plating,/area/template_noop)
"dn" = (/obj/decal/cleanable/dirt,/obj/decal/cleanable/dirt,/turf/simulated/floor/tiled/steel_grid,/area/map_template/build/build19)
"dL" = (/obj/random/trash,/obj/decal/cleanable/dirt,/obj/decal/cleanable/dirt,/turf/simulated/floor/tiled,/area/map_template/build/build19)
"dN" = (/obj/machinery/power/smes/buildable/preset/on_full,/obj/structure/cable{d2 = 4; icon_state = "0-4"},/obj/decal/cleanable/dirt,/turf/simulated/floor/plating,/area/map_template/build/build19)
"eL" = (/obj/structure/table/steel_reinforced,/obj/floor_decal/corner/yellow/border,/obj/random/technology_scanner,/obj/decal/cleanable/dirt,/obj/decal/cleanable/dirt,/turf/simulated/floor/tiled,/area/map_template/build/build19)
"eU" = (/obj/structure/cable{d1 = 1; d2 = 4; icon_state = "1-4"},/obj/structure/catwalk,/obj/floor_decal/industrial/warning{dir = 1},/obj/machinery/light/small{dir = 8},/obj/decal/cleanable/dirt,/turf/simulated/floor/plating,/area/map_template/build/build19)
"eY" = (/obj/floor_decal/corner/yellow{dir = 9},/obj/random/trash,/obj/decal/cleanable/dirt,/turf/simulated/floor/tiled,/area/map_template/build/build19)
"fc" = (/obj/structure/table/rack,/obj/random/soap,/obj/random/loot{pixel_y = 5},/turf/simulated/floor/tiled/techfloor/grid,/area/map_template/build/build19)
"fd" = (/obj/floor_decal/industrial/warning/corner{dir = 1},/obj/floor_decal/corner/yellow/border,/obj/random/trash,/obj/decal/cleanable/dirt,/obj/decal/cleanable/dirt,/turf/simulated/floor/tiled,/area/map_template/build/build19)
"fj" = (/obj/floor_decal/industrial/warning{dir = 4},/obj/floor_decal/corner/yellow/border{dir = 8},/turf/simulated/floor/tiled/monotile,/area/map_template/build/build19)
"fy" = (/obj/floor_decal/industrial/warning/corner{dir = 4},/obj/random/trash,/obj/decal/cleanable/dirt,/turf/simulated/floor/tiled,/area/map_template/build/build19)
"fN" = (/obj/structure/bed/chair/office/dark{dir = 8},/obj/decal/cleanable/dirt,/turf/simulated/floor/plating,/area/map_template/build/build19)
"fX" = (/obj/structure/cable{d1 = 1; d2 = 8; icon_state = "1-8"},/turf/simulated/floor/plating,/area/template_noop)
"gn" = (/obj/structure/bed/chair/office/comfy/yellow,/obj/floor_decal/corner/yellow/border{dir = 1},/obj/decal/cleanable/dirt,/turf/simulated/floor/tiled,/area/map_template/build/build19)
"gy" = (/obj/random/trash,/obj/decal/cleanable/dirt,/obj/decal/cleanable/dirt,/turf/simulated/floor/plating,/area/map_template/build/build19)
"hh" = (/obj/structure/cable{d1 = 4; d2 = 8; icon_state = "4-8"},/turf/simulated/wall/concrete,/area/map_template/build/build19)
"hH" = (/obj/floor_decal/corner/yellow/three_quarters{dir = 4},/obj/decal/cleanable/dirt,/obj/decal/cleanable/dirt,/turf/simulated/floor/tiled,/area/map_template/build/build19)
"ig" = (/obj/floor_decal/corner/yellow{dir = 9},/obj/structure/holoplant,/obj/decal/cleanable/dirt,/turf/simulated/floor/tiled,/area/map_template/build/build19)
"jt" = (/obj/structure/table/steel_reinforced,/obj/floor_decal/corner/yellow{dir = 10},/obj/decal/cleanable/dirt,/obj/decal/cleanable/dirt,/turf/simulated/floor/tiled,/area/map_template/build/build19)
"jH" = (/obj/floor_decal/industrial/warning{dir = 1},/obj/floor_decal/corner/yellow/border,/obj/machinery/light{dir = 8},/turf/simulated/floor/tiled,/area/map_template/build/build19)
"kh" = (/obj/floor_decal/corner/yellow{dir = 6},/obj/decal/cleanable/dirt,/turf/simulated/floor/tiled,/area/map_template/build/build19)
"kk" = (/obj/structure/table/steel_reinforced,/obj/floor_decal/corner/yellow/border{dir = 4},/obj/decal/cleanable/dirt,/obj/decal/cleanable/dirt,/turf/simulated/floor/tiled,/area/map_template/build/build19)
"ku" = (/turf/simulated/wall/concrete,/area/map_template/build/build19)
"kx" = (/obj/floor_decal/industrial/warning{dir = 8},/obj/floor_decal/corner/yellow/border{dir = 4},/obj/decal/cleanable/dirt,/turf/simulated/floor/tiled/monotile,/area/map_template/build/build19)
"kU" = (/obj/floor_decal/industrial/warning,/obj/floor_decal/corner/yellow/border{dir = 1},/obj/decal/cleanable/dirt,/obj/decal/cleanable/dirt,/turf/simulated/floor/tiled/monotile,/area/map_template/build/build19)
"kW" = (/obj/structure/cable{d1 = 4; d2 = 8; icon_state = "4-8"},/obj/landmark/damager,/turf/simulated/wall/concrete,/area/map_template/build/build19)
"kZ" = (/turf/simulated/floor/plating,/area/template_noop)
"lw" = (/obj/structure/table/steel_reinforced,/obj/floor_decal/corner/yellow/border{dir = 6},/obj/random/tech_supply,/obj/decal/cleanable/dirt,/obj/decal/cleanable/dirt,/turf/simulated/floor/tiled,/area/map_template/build/build19)
"lH" = (/obj/decal/cleanable/blood/splatter,/obj/decal/cleanable/dirt,/obj/decal/cleanable/dirt,/turf/simulated/floor/tiled,/area/map_template/build/build19)
"lQ" = (/obj/floor_decal/industrial/warning{dir = 6},/obj/floor_decal/corner/yellow/bordercorner{dir = 1},/obj/decal/cleanable/dirt,/turf/simulated/floor/tiled/monotile,/area/map_template/build/build19)
"lY" = (/obj/machinery/door/unpowered/simple/iron,/turf/simulated/floor/tiled/steel_ridged,/area/map_template/build/build19)
"mQ" = (/obj/floor_decal/solarpanel,/obj/machinery/power/solar{efficiency = 4; health = 50},/obj/structure/cable{d2 = 4; icon_state = "0-4"},/turf/simulated/floor/plating,/area/template_noop)
"nA" = (/obj/catwalk_plated,/obj/structure/bed/chair/office/dark,/obj/decal/cleanable/dirt,/turf/simulated/floor/plating,/area/map_template/build/build19)
"nG" = (/turf/simulated/floor/exoplanet/concrete,/area/template_noop)
"od" = (/obj/floor_decal/corner/yellow{dir = 6},/obj/decal/cleanable/blood/splatter,/turf/simulated/floor/tiled,/area/map_template/build/build19)
"on" = (/obj/structure/largecrate,/obj/random/circuitboard,/obj/random/contraband,/obj/random/contraband,/turf/simulated/floor/tiled/techfloor/grid,/area/map_template/build/build19)
"oz" = (/obj/structure/table/steel_reinforced,/obj/floor_decal/corner/yellow/border,/obj/random/technology_scanner,/obj/decal/cleanable/dirt,/turf/simulated/floor/tiled,/area/map_template/build/build19)
"oP" = (/obj/random/trash,/obj/random/torchcloset,/obj/random/voidhelmet,/obj/machinery/light/small,/turf/simulated/floor/tiled/techfloor/grid,/area/map_template/build/build19)
"pq" = (/obj/machinery/power/terminal{dir = 1},/obj/structure/cable{d2 = 8; icon_state = "0-8"},/obj/structure/catwalk,/obj/floor_decal/industrial/warning{dir = 1},/obj/decal/cleanable/dirt,/turf/simulated/floor/plating,/area/map_template/build/build19)
"pT" = (/obj/floor_decal/industrial/warning{dir = 10},/obj/floor_decal/corner/yellow/bordercorner{dir = 4},/obj/random/trash,/obj/decal/cleanable/dirt,/turf/simulated/floor/tiled/monotile,/area/map_template/build/build19)
"qp" = (/obj/structure/cable{d1 = 1; d2 = 4; icon_state = "1-4"},/turf/simulated/wall/concrete,/area/map_template/build/build19)
"qI" = (/obj/machinery/shieldwallgen/online,/obj/structure/cable{d2 = 8; icon_state = "0-8"},/turf/simulated/floor/tiled/steel_ridged,/area/map_template/build/build19)
"re" = (/obj/random/trash,/turf/simulated/floor/exoplanet/concrete/reinforced/road,/area/template_noop)
"rv" = (/obj/item/ammo_casing/pistol/used,/obj/item/ammo_casing/pistol/used{dir = 1; pixel_x = -5; pixel_y = -5},/obj/gibspawner/human,/obj/decal/cleanable/dirt,/turf/simulated/floor/plating,/area/map_template/build/build19)
"rM" = (/obj/floor_decal/solarpanel,/obj/machinery/power/solar{efficiency = 4; health = 50},/obj/structure/cable{d1 = 4; d2 = 8; icon_state = "4-8"},/obj/structure/cable{d2 = 4; icon_state = "0-4"},/turf/simulated/floor/plating,/area/template_noop)
"rU" = (/obj/wallframe_spawn/reinforced,/turf/simulated/floor/plating,/area/map_template/build/build19)
"sa" = (/turf/simulated/floor/tiled/steel_ridged,/area/map_template/build/build19)
"si" = (/obj/structure/table/steel_reinforced,/obj/floor_decal/corner/yellow/border,/obj/decal/cleanable/dirt,/obj/decal/cleanable/dirt,/obj/random/loot,/turf/simulated/floor/tiled,/area/map_template/build/build19)
"sl" = (/obj/decal/cleanable/dirt,/turf/simulated/floor/plating,/area/map_template/build/build19)
"sp" = (/obj/structure/cable{d1 = 2; d2 = 8; icon_state = "2-8"},/obj/structure/cable{d1 = 1; d2 = 2; icon_state = "1-2"},/turf/simulated/floor/plating,/area/template_noop)
"sq" = (/obj/landmark/clear,/turf/template_noop,/area/template_noop)
"sR" = (/obj/decal/cleanable/dirt,/turf/simulated/floor/exoplanet/concrete,/area/template_noop)
"tm" = (/obj/structure/table/steel_reinforced,/obj/floor_decal/corner/yellow/border{dir = 5},/obj/decal/cleanable/dirt,/obj/decal/cleanable/dirt,/turf/simulated/floor/tiled,/area/map_template/build/build19)
"tn" = (/obj/gibspawner/human,/turf/simulated/floor/exoplanet/concrete/reinforced/road,/area/template_noop)
"tv" = (/obj/floor_decal/industrial/warning{dir = 4},/obj/floor_decal/corner/yellow/border{dir = 8},/obj/decal/cleanable/dirt,/turf/simulated/floor/tiled/monotile,/area/map_template/build/build19)
"tH" = (/obj/item/ammo_casing/pistol/used{dir = 4; pixel_x = 6; pixel_y = -7},/obj/item/ammo_casing/pistol/used{dir = 8; pixel_x = 2; pixel_y = 12},/obj/gibspawner/human,/obj/decal/cleanable/dirt,/turf/simulated/floor/plating,/area/map_template/build/build19)
"ua" = (/obj/machinery/power/solar_control/autostart,/obj/structure/cable{d1 = 2; d2 = 8; icon_state = "2-8"},/obj/structure/cable{d2 = 8; icon_state = "0-8"},/turf/simulated/floor/plating,/area/map_template/build/build19)
"uc" = (/obj/machinery/pipedispenser,/obj/decal/cleanable/dirt,/turf/simulated/floor/tiled/monotile,/area/map_template/build/build19)
"un" = (/obj/wallframe_spawn/no_grille,/turf/simulated/floor/plating,/area/map_template/build/build19)
"ur" = (/obj/machinery/door/unpowered/simple/iron,/turf/simulated/floor/tiled/techfloor/grid,/area/map_template/build/build19)
"uB" = (/obj/random/trash,/turf/simulated/floor/plating,/area/map_template/build/build19)
"uG" = (/obj/floor_decal/corner/yellow/border{dir = 5},/obj/decal/cleanable/dirt,/obj/decal/cleanable/dirt,/turf/simulated/floor/tiled,/area/map_template/build/build19)
"uQ" = (/obj/floor_decal/corner/yellow{dir = 9},/obj/decal/cleanable/dirt,/turf/simulated/floor/tiled/steel_grid,/area/map_template/build/build19)
"vm" = (/obj/floor_decal/corner/yellow{dir = 6},/obj/machinery/light{dir = 4},/obj/decal/cleanable/dirt,/turf/simulated/floor/tiled/steel_grid,/area/map_template/build/build19)
"vx" = (/obj/random/trash,/obj/decal/cleanable/dirt,/obj/decal/cleanable/dirt,/turf/simulated/floor/tiled/steel_grid,/area/map_template/build/build19)
"vG" = (/obj/structure/cable{d1 = 1; d2 = 2; icon_state = "1-2"},/obj/structure/catwalk,/obj/decal/cleanable/dirt,/obj/structure/table/rack,/turf/simulated/floor/plating,/area/map_template/build/build19)
"wJ" = (/obj/structure/table/steel_reinforced,/obj/floor_decal/corner/yellow/border{dir = 8},/obj/random/snack,/obj/decal/cleanable/dirt,/obj/decal/cleanable/dirt,/turf/simulated/floor/tiled,/area/map_template/build/build19)
"wP" = (/obj/machinery/door/airlock/hatch,/turf/simulated/floor/tiled/steel_ridged,/area/map_template/build/build19)
"xe" = (/obj/structure/cable{d1 = 1; d2 = 4; icon_state = "1-4"},/obj/structure/cable{d1 = 1; d2 = 8; icon_state = "1-8"},/turf/simulated/floor/tiled/steel_ridged,/area/map_template/build/build19)
"xl" = (/obj/machinery/portable_atmospherics/canister/hydrogen,/obj/decal/cleanable/dirt,/obj/decal/cleanable/dirt,/turf/simulated/floor/tiled/monotile,/area/map_template/build/build19)
"xo" = (/obj/decal/cleanable/dirt,/turf/simulated/floor/tiled/steel_grid,/area/map_template/build/build19)
"xX" = (/obj/floor_decal/corner/yellow/border,/obj/random/trash,/obj/decal/cleanable/dirt,/turf/simulated/floor/tiled,/area/map_template/build/build19)
"yC" = (/obj/structure/table/rack,/obj/random/firstaid,/obj/decal/cleanable/dirt,/turf/simulated/floor/tiled/techfloor/grid,/area/map_template/build/build19)
"yH" = (/obj/floor_decal/corner/yellow{dir = 6},/obj/machinery/light{dir = 4},/obj/decal/cleanable/dirt,/obj/decal/cleanable/dirt,/turf/simulated/floor/tiled,/area/map_template/build/build19)
"zD" = (/obj/structure/table/steel_reinforced,/obj/floor_decal/corner/yellow/bordercorner{dir = 8},/obj/random/coin,/obj/decal/cleanable/dirt,/turf/simulated/floor/tiled,/area/map_template/build/build19)
"zT" = (/obj/structure/cable{d1 = 2; d2 = 8; icon_state = "2-8"},/obj/landmark/damager,/turf/simulated/wall/concrete,/area/map_template/build/build19)
"AT" = (/obj/floor_decal/corner/yellow{dir = 6},/obj/machinery/portable_atmospherics/powered/scrubber,/obj/decal/cleanable/dirt,/obj/decal/cleanable/dirt,/turf/simulated/floor/tiled,/area/map_template/build/build19)
"Bj" = (/obj/structure/bed/chair/office/comfy/yellow,/obj/decal/cleanable/dirt,/turf/simulated/floor/tiled,/area/map_template/build/build19)
"BQ" = (/obj/structure/cable{d1 = 2; d2 = 4; icon_state = "2-4"},/obj/structure/cable{d1 = 2; d2 = 8; icon_state = "2-8"},/turf/simulated/floor/plating,/area/template_noop)
"CX" = (/obj/structure/cable{d1 = 4; d2 = 8; icon_state = "4-8"},/obj/structure/cable{d1 = 2; d2 = 4; icon_state = "2-4"},/obj/structure/cable{d1 = 1; d2 = 4; icon_state = "1-4"},/turf/simulated/floor/plating,/area/template_noop)
"DC" = (/turf/simulated/floor/tiled,/area/map_template/build/build19)
"DQ" = (/obj/floor_decal/corner/yellow{dir = 6},/obj/gibspawner/human,/turf/simulated/floor/tiled,/area/map_template/build/build19)
"Ei" = (/obj/floor_decal/corner/yellow{dir = 9},/obj/random/trash,/obj/machinery/light{dir = 8},/obj/decal/cleanable/cobweb,/turf/simulated/floor/tiled/steel_grid,/area/map_template/build/build19)
"El" = (/obj/machinery/light{dir = 8},/obj/decal/cleanable/dirt,/obj/decal/cleanable/dirt,/turf/simulated/floor/plating,/area/map_template/build/build19)
"Fn" = (/obj/item/ammo_casing/pistol/used{dir = 4; pixel_x = 6; pixel_y = -7},/obj/item/ammo_casing/pistol/used{dir = 8; pixel_x = 2; pixel_y = 12},/obj/decal/cleanable/dirt,/obj/decal/cleanable/dirt,/turf/simulated/floor/plating,/area/map_template/build/build19)
"FO" = (/obj/floor_decal/industrial/warning{dir = 8},/obj/floor_decal/corner/yellow/border{dir = 4},/obj/random/tank,/obj/decal/cleanable/dirt,/turf/simulated/floor/tiled/monotile,/area/map_template/build/build19)
"FP" = (/obj/catwalk_plated,/obj/machinery/light{dir = 4},/obj/decal/cleanable/dirt,/turf/simulated/floor/plating,/area/map_template/build/build19)
"FQ" = (/obj/decal/cleanable/blood/splatter,/obj/decal/cleanable/dirt,/obj/decal/cleanable/dirt,/turf/simulated/floor/plating,/area/map_template/build/build19)
"Gk" = (/obj/floor_decal/corner/yellow/border{dir = 1},/obj/floor_decal/corner/yellow{dir = 10},/obj/machinery/light,/turf/simulated/floor/tiled,/area/map_template/build/build19)
"Gl" = (/obj/machinery/shieldwallgen/online,/obj/structure/cable{d2 = 4; icon_state = "0-4"},/turf/simulated/floor/tiled/steel_ridged,/area/map_template/build/build19)
"Gn" = (/obj/structure/table/steel_reinforced,/obj/floor_decal/corner/yellow/border{dir = 8},/obj/random/smokes,/obj/decal/cleanable/dirt,/turf/simulated/floor/tiled,/area/map_template/build/build19)
"Gp" = (/obj/structure/cable{d1 = 1; d2 = 2; icon_state = "1-2"},/obj/structure/cable{d1 = 1; d2 = 8; icon_state = "1-8"},/obj/structure/cable{d1 = 1; d2 = 4; icon_state = "1-4"},/turf/simulated/floor/tiled/steel_ridged,/area/map_template/build/build19)
"GG" = (/obj/floor_decal/industrial/warning{dir = 4},/obj/floor_decal/corner/yellow/border{dir = 8},/obj/decal/cleanable/blood/splatter,/obj/decal/cleanable/dirt,/turf/simulated/floor/tiled/monotile,/area/map_template/build/build19)
"Hm" = (/obj/floor_decal/corner/yellow{dir = 9},/obj/decal/cleanable/dirt,/turf/simulated/floor/tiled,/area/map_template/build/build19)
"HE" = (/obj/catwalk_plated,/obj/decal/cleanable/dirt,/obj/decal/cleanable/dirt,/turf/simulated/floor/plating,/area/map_template/build/build19)
"Ia" = (/obj/decal/cleanable/blood/splatter,/turf/simulated/floor/exoplanet/concrete,/area/template_noop)
"Iy" = (/obj/decal/cleanable/dirt,/obj/decal/cleanable/dirt,/obj/decal/cleanable/dirt,/obj/decal/cleanable/dirt,/obj/decal/cleanable/dirt,/turf/simulated/floor/plating,/area/map_template/build/build19)
"IM" = (/obj/floor_decal/corner/yellow{dir = 10},/obj/random/trash,/obj/decal/cleanable/dirt,/obj/decal/cleanable/dirt,/turf/simulated/floor/tiled,/area/map_template/build/build19)
"Kq" = (/obj/random/suit,/obj/structure/largecrate,/obj/decal/cleanable/dirt,/turf/simulated/floor/tiled/techfloor/grid,/area/map_template/build/build19)
"KH" = (/obj/decal/cleanable/dirt,/obj/random/trash,/turf/simulated/floor/exoplanet/concrete/reinforced/road,/area/template_noop)
"KS" = (/obj/decal/cleanable/dirt,/obj/decal/cleanable/dirt,/turf/simulated/floor/plating,/area/map_template/build/build19)
"Lg" = (/obj/random/trash,/obj/structure/table/rack,/obj/random/hat,/obj/decal/cleanable/dirt,/turf/simulated/floor/tiled/techfloor/grid,/area/map_template/build/build19)
"Mh" = (/obj/floor_decal/industrial/warning{dir = 8},/obj/floor_decal/corner/yellow/border{dir = 4},/obj/machinery/portable_atmospherics/canister/empty/phoron,/obj/decal/cleanable/dirt,/turf/simulated/floor/tiled/monotile,/area/map_template/build/build19)
"Mp" = (/obj/decal/cleanable/dirt,/obj/random/trash,/turf/simulated/floor/exoplanet/concrete,/area/template_noop)
"Mx" = (/obj/structure/cable{d1 = 1; d2 = 2; icon_state = "1-2"},/obj/structure/catwalk,/obj/floor_decal/industrial/warning/corner{dir = 1},/obj/decal/cleanable/dirt,/turf/simulated/floor/plating,/area/map_template/build/build19)
"MG" = (/obj/structure/table/steel_reinforced,/obj/floor_decal/corner/yellow/border{dir = 4},/obj/random/drinkbottle,/obj/decal/cleanable/dirt,/obj/decal/cleanable/dirt,/turf/simulated/floor/tiled,/area/map_template/build/build19)
"MH" = (/turf/simulated/floor/exoplanet/concrete/reinforced/road,/area/template_noop)
"ML" = (/obj/decal/cleanable/blood/splatter,/obj/decal/cleanable/dirt,/turf/simulated/floor/plating,/area/map_template/build/build19)
"NP" = (/obj/decal/cleanable/dirt,/turf/simulated/floor/tiled/techfloor,/area/map_template/build/build19)
"Ol" = (/obj/random/lilgun,/obj/decal/cleanable/dirt,/turf/simulated/floor/plating,/area/map_template/build/build19)
"Ph" = (/obj/decal/cleanable/blood/gibs/robot,/obj/decal/cleanable/dirt,/turf/simulated/floor/plating,/area/map_template/build/build19)
"Po" = (/obj/random/tool,/obj/structure/largecrate,/obj/random/circuitboard,/obj/random/circuitboard,/obj/random/circuitboard,/turf/simulated/floor/tiled/techfloor/grid,/area/map_template/build/build19)
"Qj" = (/obj/machinery/wish_granter{charges = 0},/obj/structure/cable{d1 = 1; d2 = 2; icon_state = "1-2"},/obj/effect/reactor_radiate{radiation_power = 20; req_range = 1},/turf/simulated/floor/tiled/monotile,/area/map_template/build/build19)
"Qm" = (/obj/floor_decal/corner/yellow/border,/obj/decal/cleanable/dirt,/obj/decal/cleanable/dirt,/turf/simulated/floor/tiled,/area/map_template/build/build19)
"Rj" = (/obj/machinery/light{dir = 1},/turf/simulated/floor/exoplanet/concrete,/area/template_noop)
"Rm" = (/obj/floor_decal/corner/yellow/border{dir = 10},/obj/decal/cleanable/dirt,/obj/decal/cleanable/dirt,/turf/simulated/floor/tiled,/area/map_template/build/build19)
"RH" = (/obj/structure/table/steel_reinforced,/obj/floor_decal/corner/yellow/border{dir = 10},/obj/random/accessory,/obj/decal/cleanable/dirt,/obj/decal/cleanable/dirt,/turf/simulated/floor/tiled,/area/map_template/build/build19)
"RX" = (/obj/random/tool,/obj/random/tool,/obj/structure/largecrate,/obj/random/circuitboard,/obj/random/circuitboard,/obj/random/circuitboard,/obj/random/circuitboard,/obj/decal/cleanable/dirt,/turf/simulated/floor/tiled/techfloor/grid,/area/map_template/build/build19)
"SQ" = (/obj/random/trash,/turf/simulated/floor/exoplanet/concrete,/area/template_noop)
"Tv" = (/obj/random/trash,/obj/decal/cleanable/dirt,/turf/simulated/floor/plating,/area/map_template/build/build19)
"TB" = (/obj/structure/catwalk,/obj/random/trash,/obj/decal/cleanable/dirt,/turf/simulated/floor/plating,/area/map_template/build/build19)
"Uh" = (/obj/floor_decal/corner/yellow{dir = 9},/obj/machinery/light{dir = 8},/obj/decal/cleanable/dirt,/turf/simulated/floor/tiled/steel_grid,/area/map_template/build/build19)
"Un" = (/obj/decal/cleanable/dirt,/obj/random/trash,/obj/decal/cleanable/dirt,/obj/decal/cleanable/dirt,/turf/simulated/floor/exoplanet/concrete,/area/template_noop)
"UF" = (/obj/floor_decal/corner/yellow{dir = 6},/turf/simulated/floor/tiled,/area/map_template/build/build19)
"US" = (/obj/structure/table/steel_reinforced,/obj/machinery/light{dir = 8},/obj/decal/cleanable/dirt,/obj/random/loot{pixel_y = 5},/turf/simulated/floor/tiled,/area/map_template/build/build19)
"Vg" = (/obj/random/toolbox,/obj/structure/table/rack,/obj/decal/cleanable/dirt,/turf/simulated/floor/tiled/techfloor/grid,/area/map_template/build/build19)
"Vm" = (/obj/landmark/damager,/obj/landmark/damager,/turf/simulated/wall/concrete,/area/map_template/build/build19)
"VB" = (/obj/random/trash,/obj/decal/cleanable/dirt,/turf/simulated/floor/tiled/techfloor,/area/map_template/build/build19)
"VV" = (/obj/structure/catwalk,/obj/decal/cleanable/dirt,/turf/simulated/floor/plating,/area/map_template/build/build19)
"VW" = (/obj/machinery/power/tracker,/obj/structure/cable{d2 = 8; icon_state = "0-8"},/turf/simulated/floor/plating,/area/template_noop)
"Wh" = (/turf/simulated/floor/plating,/area/map_template/build/build19)
"WB" = (/obj/structure/table/steel_reinforced,/obj/floor_decal/corner/yellow/bordercorner{dir = 4},/obj/floor_decal/corner/yellow{dir = 10},/obj/random/storage,/obj/decal/cleanable/dirt,/turf/simulated/floor/tiled,/area/map_template/build/build19)
"WI" = (/turf/template_noop,/area/template_noop)
"Xf" = (/obj/structure/table/steel_reinforced,/obj/floor_decal/corner/yellow/border{dir = 1},/obj/random/toy,/obj/decal/cleanable/dirt,/turf/simulated/floor/tiled,/area/map_template/build/build19)
"Xo" = (/obj/item/ammo_casing/pistol/used{dir = 8; pixel_x = 2; pixel_y = 12},/obj/item/ammo_casing/pistol/used{dir = 1; pixel_x = -5; pixel_y = -5},/obj/decal/cleanable/dirt,/turf/simulated/floor/plating,/area/map_template/build/build19)
"Xv" = (/obj/floor_decal/corner/yellow{dir = 6},/obj/decal/cleanable/dirt,/turf/simulated/floor/tiled/steel_grid,/area/map_template/build/build19)
"Ys" = (/obj/random/vendor,/obj/decal/cleanable/dirt,/turf/simulated/floor/tiled/monotile,/area/map_template/build/build19)
"Yx" = (/obj/structure/cable{d1 = 2; d2 = 8; icon_state = "2-8"},/obj/floor_decal/industrial/warning{dir = 8},/obj/structure/cable{d2 = 8; icon_state = "0-8"},/obj/structure/catwalk,/obj/machinery/power/apc/auto_access/unlocked{dir = 1; pixel_y = 24},/obj/decal/cleanable/dirt,/turf/simulated/floor/plating,/area/map_template/build/build19)
"YL" = (/obj/landmark/damager,/turf/simulated/wall/concrete,/area/map_template/build/build19)
"YO" = (/obj/floor_decal/industrial/warning{dir = 1},/obj/machinery/light{dir = 4},/obj/decal/cleanable/dirt,/turf/simulated/floor/tiled,/area/map_template/build/build19)
"YQ" = (/obj/random/toolbox,/obj/structure/largecrate,/obj/decal/cleanable/dirt,/obj/decal/cleanable/cobweb2,/turf/simulated/floor/tiled/techfloor/grid,/area/map_template/build/build19)
"Ze" = (/obj/machinery/portable_atmospherics/canister/air,/obj/machinery/light{dir = 8},/obj/decal/cleanable/dirt,/turf/simulated/floor/plating,/area/map_template/build/build19)
"Zf" = (/obj/catwalk_plated,/turf/simulated/floor/plating,/area/map_template/build/build19)
"Zq" = (/obj/decal/cleanable/dirt,/turf/template_noop,/area/template_noop)
"ZH" = (/obj/structure/table/steel_reinforced,/obj/floor_decal/corner/yellow{dir = 10},/obj/decal/cleanable/dirt,/obj/random/loot,/turf/simulated/floor/tiled,/area/map_template/build/build19)
"ZO" = (/obj/decal/cleanable/blood/splatter,/turf/simulated/floor/plating,/area/map_template/build/build19)

(1,1,1) = {"
mQrMBQVWnGWIWIWIWIWIWIWIWIWIWIsqsqsqsqsqWI
mQrMspkZnGnGnGWIWIWInGSQnGnGsqnGnGIasqsqsq
mQrMspkuYLYLYLkukukukuYLYLkukuYLYLuBslIasq
mQrMCXhhuadNYxkuPoRXRXfcVgYQkuZeFQFnslsqsq
mQrMdakueUpqMxurNPVBNPNPNPNPurslgyrvXosqsq
mQrMfXYLTBVVvGkuKqbcyCLgoPonkuDCIyslWhsqWI
nGnGnGYLkuwPqphhkWkWzTkuYLYLYLlHOlZOkunGWI
WInGYLYLYsaikuEiMhGlGpqIfjvmVmEldLkhYLnGWI
WInGkuwJdLyHYLuQFOsaQjsatvTvPhtHKSkhYLnGWI
WISQkuGnBjUFkuuQkxGlxeqIGGXvMLfNtmkhunsqWI
WInGYLRHsiZfkuUhpTcRkUkUlQvmVmHEMGodunsqWI
WIsqunHmdnFPYLwPYLrUrUrUYLwPYLUScUDQunsqWI
WIsquneYdnHEkujHfdeLozzDfyYOYLnAkkaEYLnGWI
WIsqunHmvxailYdndnbKdnRmQmQmYLxXlwkhkuWIWI
WInGYLigdnATkuXfgnuGvxxodnxolYHEHEyHYLnGWI
WInGYLYLlYkuYLZHjtWBGkZfHExlkuucIMhHYLSQWI
WInGnGnGSQRjYLYLYLkukuYLYLYLYLkukuYLYLSQWI
WIZqsRUnSQnGnGnGSQsRnGsqsqsqsRsqsqsqsqSQWI
ZqaQreKHMHsqaQaQsqsqtnresqaQMHresqsqsqsqZq
WIWIsqMHsqaQaQsqaQaQsqaQsqsqMHaQsqaQsqWIWI
WIWIZqZqWInGSQZqZqsRMpnGsqnGMpZqsRsRnGWIWI
"}
