"a" = (/obj/landmark/exoplanet_spawn/plant,/turf/template_noop,/area/template_noop)
"b" = (/obj/landmark/exoplanet_spawn/plant,/obj/decal/cleanable/dirt,/obj/decal/cleanable/dirt,/obj/decal/cleanable/dirt,/turf/template_noop,/area/template_noop)
"e" = (/obj/landmark/exoplanet_spawn/plant,/obj/decal/cleanable/dirt,/turf/template_noop,/area/template_noop)
"f" = (/obj/landmark/scorcher,/obj/decal/cleanable/dirt,/obj/decal/cleanable/dirt,/turf/simulated/floor/exoplanet/concrete/reinforced/road,/area/template_noop)
"j" = (/obj/landmark/scorcher,/turf/simulated/floor/exoplanet/concrete/reinforced/road,/area/template_noop)
"k" = (/obj/landmark/exoplanet_spawn/plant,/obj/decal/cleanable/dirt,/obj/decal/cleanable/dirt,/turf/template_noop,/area/template_noop)
"l" = (/obj/decal/cleanable/dirt,/obj/random/loot{spawn_nothing_percentage = 90},/turf/simulated/floor/exoplanet/concrete/reinforced/road,/area/template_noop)
"m" = (/obj/landmark/scorcher,/obj/item/stack/material/rods,/obj/decal/cleanable/dirt,/obj/decal/cleanable/dirt,/turf/simulated/floor/exoplanet/concrete/reinforced/road,/area/template_noop)
"n" = (/obj/item/stack/material/rods,/turf/template_noop,/area/template_noop)
"o" = (/obj/decal/cleanable/dirt,/turf/simulated/floor/exoplanet/concrete,/area/template_noop)
"p" = (/obj/decal/cleanable/dirt,/obj/decal/cleanable/dirt,/turf/simulated/floor/exoplanet/concrete/reinforced/road,/area/template_noop)
"q" = (/obj/landmark/scorcher,/obj/decal/cleanable/dirt,/turf/simulated/floor/exoplanet/concrete/reinforced/road,/area/template_noop)
"t" = (/obj/landmark/scorcher,/obj/decal/cleanable/dirt,/obj/decal/cleanable/dirt,/turf/simulated/floor/exoplanet/concrete,/area/template_noop)
"w" = (/turf/template_noop,/area/template_noop)
"x" = (/turf/simulated/floor/exoplanet/concrete,/area/template_noop)
"B" = (/turf/simulated/floor/exoplanet/concrete/reinforced/road,/area/template_noop)
"D" = (/obj/decal/cleanable/dirt,/obj/decal/cleanable/dirt,/turf/simulated/floor/exoplanet/concrete,/area/template_noop)
"G" = (/obj/decal/cleanable/dirt,/obj/decal/cleanable/dirt,/obj/decal/cleanable/dirt,/obj/decal/cleanable/dirt,/turf/simulated/floor/exoplanet/concrete/reinforced/road,/area/template_noop)
"I" = (/obj/decal/cleanable/dirt,/turf/template_noop,/area/template_noop)
"J" = (/obj/landmark/clear,/obj/decal/cleanable/dirt,/turf/template_noop,/area/template_noop)
"K" = (/obj/landmark/scorcher,/obj/decal/cleanable/dirt,/turf/simulated/floor/exoplanet/concrete,/area/template_noop)
"M" = (/obj/decal/cleanable/dirt,/turf/simulated/floor/exoplanet/concrete/reinforced/road,/area/template_noop)
"N" = (/obj/landmark/clear,/turf/template_noop,/area/template_noop)
"R" = (/obj/landmark/clear,/obj/decal/cleanable/dirt,/obj/decal/cleanable/dirt,/turf/template_noop,/area/template_noop)
"T" = (/obj/landmark/scorcher,/turf/simulated/floor/exoplanet/concrete,/area/template_noop)
"U" = (/obj/item/stack/material/rods,/obj/decal/cleanable/dirt,/turf/template_noop,/area/template_noop)

(1,1,1) = {"
wNaeJoTxnJxxTToRRxooNxTTKwUJRKKIUNI
NeJpqmBkpIJMNjjqqMpMpakqJMfqMNpMqJJ
JkqMBJMkMMRpMJpBMGlBqfBNepJMqeMbMMN
NqBNMeMlMNpakeMBBqBBpjBpkeaJjplkJqN
NNBMnepJRpBjqaNaMBMjMMUqpJJpBMqfpfj
naexTIJDKwNNotIotJKtNNnTTNJNKnJDKKI
"}
