"aa" = (/obj/paint/green,/turf/simulated/wall,/area/map_template/wreck/wreckfour)
"ab" = (/obj/wallframe_spawn/reinforced,/obj/paint/green,/turf/simulated/floor/plating,/area/map_template/wreck/wreckfour)
"ac" = (/obj/floor_decal/corner/b_green/border{dir = 1},/obj/structure/bed/chair/padded/green,/turf/simulated/floor/tiled/dark/monotile,/area/map_template/wreck/wreckfour)
"ad" = (/obj/floor_decal/corner/b_green/border{dir = 1},/obj/structure/table/woodentable/walnut,/turf/simulated/floor/tiled/dark/monotile,/area/map_template/wreck/wreckfour)
"ae" = (/obj/floor_decal/corner/b_green/border{dir = 1},/obj/structure/mopbucket,/turf/simulated/floor/tiled/dark/monotile,/area/map_template/wreck/wreckfour)
"af" = (/obj/floor_decal/corner/b_green/border{dir = 1},/obj/structure/flora/pottedplant/minitree,/obj/machinery/light/invisible{dir = 1},/turf/simulated/floor/tiled/dark/monotile,/area/map_template/wreck/wreckfour)
"ag" = (/obj/floor_decal/corner/b_green/border{dir = 1},/obj/structure/bed/chair/padded/green{dir = 4},/turf/simulated/floor/tiled/dark/monotile,/area/map_template/wreck/wreckfour)
"ah" = (/obj/floor_decal/corner/b_green/border{dir = 1},/obj/structure/table/woodentable/walnut,/obj/random/junkyard/advdevice,/turf/simulated/floor/tiled/dark/monotile,/area/map_template/wreck/wreckfour)
"ai" = (/obj/floor_decal/corner/b_green/border{dir = 1},/obj/structure/bed/chair/padded/green{dir = 8},/turf/simulated/floor/tiled/dark/monotile,/area/map_template/wreck/wreckfour)
"aj" = (/obj/floor_decal/borderfloor/corner,/obj/floor_decal/spline/fancy/wood/corner,/obj/machinery/portable_atmospherics/powered/scrubber/broken,/obj/machinery/light{dir = 1},/turf/simulated/floor/tiled/dark,/area/map_template/wreck/wreckfour)
"ak" = (/obj/floor_decal/borderfloor,/obj/floor_decal/spline/fancy/wood,/turf/simulated/floor/tiled/dark,/area/map_template/wreck/wreckfour)
"al" = (/obj/floor_decal/spline/fancy/wood/corner,/obj/floor_decal/spline/fancy/wood/corner{dir = 8},/turf/simulated/floor/tiled/dark,/area/map_template/wreck/wreckfour)
"am" = (/obj/floor_decal/borderfloor,/obj/floor_decal/spline/fancy/wood,/obj/structure/bed/chair/padded/green{dir = 1},/turf/simulated/floor/tiled/dark,/area/map_template/wreck/wreckfour)
"an" = (/obj/floor_decal/borderfloor/corner{dir = 8},/obj/floor_decal/spline/fancy/wood/corner{dir = 8},/obj/structure/closet/crate/secure/hydrosec,/obj/machinery/light{dir = 1},/turf/simulated/floor/tiled/dark,/area/map_template/wreck/wreckfour)
"ao" = (/obj/floor_decal/borderfloor/corner,/obj/floor_decal/spline/fancy/wood/corner,/obj/machinery/newscaster{pixel_y = 30},/turf/simulated/floor/tiled/dark,/area/map_template/wreck/wreckfour)
"ap" = (/obj/floor_decal/borderfloor{dir = 6},/obj/floor_decal/spline/fancy/wood{dir = 6; icon_state = "spline_fancy"},/obj/decal/cleanable/dirt,/turf/simulated/floor/tiled/dark,/area/map_template/wreck/wreckfour)
"aq" = (/turf/simulated/floor/exoplanet/grass,/area/map_template/wreck/wreckfour)
"ar" = (/obj/floor_decal/spline/fancy/wood{dir = 8},/obj/floor_decal/spline/fancy/wood{dir = 4},/turf/simulated/floor/tiled/dark,/area/map_template/wreck/wreckfour)
"as" = (/turf/simulated/floor/exoplanet/barren,/area/map_template/wreck/wreckfour)
"at" = (/obj/floor_decal/borderfloor{dir = 10},/obj/floor_decal/spline/fancy/wood{dir = 10; icon_state = "spline_fancy"},/turf/simulated/floor/tiled/dark,/area/map_template/wreck/wreckfour)
"au" = (/obj/floor_decal/borderfloor/corner{dir = 8},/obj/floor_decal/spline/fancy/wood/corner{dir = 8},/obj/machinery/atm{pixel_y = 29},/turf/simulated/floor/tiled/dark,/area/map_template/wreck/wreckfour)
"av" = (/obj/floor_decal/borderfloor/corner,/obj/floor_decal/spline/fancy/wood/corner,/obj/machinery/light{dir = 1},/turf/simulated/floor/tiled/dark,/area/map_template/wreck/wreckfour)
"aw" = (/turf/simulated/floor/grass,/area/map_template/wreck/wreckfour)
"ax" = (/obj/floor_decal/spline/fancy/wood{dir = 8},/obj/floor_decal/spline/fancy/wood{dir = 4},/obj/machinery/light/invisible,/turf/simulated/floor/tiled/dark,/area/map_template/wreck/wreckfour)
"ay" = (/obj/machinery/beehive,/turf/simulated/floor/grass,/area/map_template/wreck/wreckfour)
"az" = (/obj/machinery/portable_atmospherics/hydroponics/soil,/turf/simulated/floor/grass,/area/map_template/wreck/wreckfour)
"aA" = (/obj/floor_decal/borderfloor/corner{dir = 8},/obj/floor_decal/spline/fancy/wood/corner{dir = 8},/obj/machinery/light{dir = 1},/obj/decal/cleanable/dirt,/turf/simulated/floor/tiled/dark,/area/map_template/wreck/wreckfour)
"aB" = (/obj/floor_decal/borderfloor/corner,/obj/floor_decal/spline/fancy/wood/corner,/obj/machinery/portable_atmospherics/canister/oxygen,/turf/simulated/floor/tiled/dark,/area/map_template/wreck/wreckfour)
"aC" = (/obj/floor_decal/spline/fancy/wood{dir = 9; icon_state = "spline_fancy"},/turf/simulated/floor/tiled/dark,/area/map_template/wreck/wreckfour)
"aD" = (/obj/floor_decal/spline/fancy/wood/corner{dir = 1},/obj/floor_decal/spline/fancy/wood/corner{dir = 4},/obj/machinery/light/invisible{dir = 1},/turf/simulated/floor/tiled/dark/monotile,/area/map_template/wreck/wreckfour)
"aE" = (/obj/floor_decal/spline/fancy/wood{dir = 5; icon_state = "spline_fancy"},/turf/simulated/floor/tiled/dark,/area/map_template/wreck/wreckfour)
"aF" = (/obj/floor_decal/borderfloor/corner{dir = 8},/obj/floor_decal/spline/fancy/wood/corner{dir = 8},/turf/simulated/floor/tiled/dark,/area/map_template/wreck/wreckfour)
"aG" = (/obj/floor_decal/borderfloor{dir = 4},/obj/floor_decal/spline/fancy/wood{dir = 4},/obj/decal/cleanable/dirt,/turf/simulated/floor/tiled/dark,/area/map_template/wreck/wreckfour)
"aH" = (/obj/floor_decal/spline/fancy/wood,/obj/structure/railing/mapped,/obj/random/intel_console,/turf/simulated/floor/tiled/dark/monotile,/area/map_template/wreck/wreckfour)
"aI" = (/obj/floor_decal/spline/fancy/wood{dir = 9; icon_state = "spline_fancy"},/obj/floor_decal/spline/fancy/wood/corner,/turf/simulated/floor/tiled/dark/monotile,/area/map_template/wreck/wreckfour)
"aJ" = (/obj/floor_decal/spline/fancy/wood/corner{dir = 4},/obj/floor_decal/spline/fancy/wood,/obj/structure/railing/mapped,/turf/simulated/floor/tiled/dark/monotile,/area/map_template/wreck/wreckfour)
"aK" = (/obj/machinery/light/invisible{dir = 4},/turf/simulated/floor/grass,/area/map_template/wreck/wreckfour)
"aL" = (/obj/floor_decal/spline/fancy/wood/corner{dir = 1},/obj/floor_decal/spline/fancy/wood,/obj/structure/railing/mapped,/obj/machinery/space_heater,/turf/simulated/floor/tiled/dark/monotile,/area/map_template/wreck/wreckfour)
"aM" = (/obj/floor_decal/spline/fancy/wood{dir = 5; icon_state = "spline_fancy"},/obj/floor_decal/spline/fancy/wood/corner{dir = 4},/obj/floor_decal/spline/fancy/wood/corner{dir = 8},/turf/simulated/floor/tiled/dark/monotile,/area/map_template/wreck/wreckfour)
"aN" = (/obj/floor_decal/borderfloor{dir = 8},/obj/floor_decal/spline/fancy/wood{dir = 8},/turf/simulated/floor/tiled/dark,/area/map_template/wreck/wreckfour)
"aO" = (/obj/floor_decal/corner/b_green/border{dir = 8},/obj/structure/bed/chair/padded/green{dir = 4},/turf/simulated/floor/tiled/dark/monotile,/area/map_template/wreck/wreckfour)
"aP" = (/obj/floor_decal/spline/fancy/wood/corner{dir = 4},/obj/floor_decal/spline/fancy/wood{dir = 4},/obj/structure/railing/mapped{dir = 4; icon_state = "railing0-1"},/turf/simulated/floor/tiled/dark/monotile,/area/map_template/wreck/wreckfour)
"aQ" = (/turf/simulated/floor/exoplanet/water/shallow,/area/map_template/wreck/wreckfour)
"aR" = (/obj/floor_decal/spline/fancy/wood/corner{dir = 1},/obj/floor_decal/spline/fancy/wood{dir = 8},/obj/structure/railing/mapped{dir = 8; icon_state = "railing0-1"},/turf/simulated/floor/tiled/dark/monotile,/area/map_template/wreck/wreckfour)
"aS" = (/obj/floor_decal/corner/b_green/border{dir = 4},/obj/structure/closet/crate/hydroponics/beekeeping,/turf/simulated/floor/tiled/dark/monotile,/area/map_template/wreck/wreckfour)
"aT" = (/obj/floor_decal/corner/b_green/border{dir = 8},/obj/structure/table/woodentable/walnut,/obj/random/junkyard/smokes,/obj/decal/cleanable/dirt,/turf/simulated/floor/tiled/dark/monotile,/area/map_template/wreck/wreckfour)
"aU" = (/obj/machinery/light/invisible{dir = 8},/turf/simulated/floor/grass,/area/map_template/wreck/wreckfour)
"aV" = (/obj/floor_decal/spline/fancy/wood{dir = 8},/obj/structure/flora/pottedplant/minitree,/obj/machinery/light/invisible{dir = 8},/turf/simulated/floor/tiled/dark/monotile,/area/map_template/wreck/wreckfour)
"aW" = (/obj/floor_decal/spline/fancy/wood{dir = 4},/obj/structure/railing/mapped{dir = 4; icon_state = "railing0-1"},/turf/simulated/floor/tiled/dark/monotile,/area/map_template/wreck/wreckfour)
"aX" = (/obj/structure/flora/tree/pine/xmas,/turf/simulated/floor/exoplanet/grass,/area/map_template/wreck/wreckfour)
"aY" = (/obj/floor_decal/spline/fancy/wood{dir = 8},/obj/structure/railing/mapped{dir = 8; icon_state = "railing0-1"},/obj/machinery/portable_atmospherics/powered/pump,/turf/simulated/floor/tiled/dark/monotile,/area/map_template/wreck/wreckfour)
"aZ" = (/obj/floor_decal/spline/fancy/wood{dir = 4},/obj/structure/flora/pottedplant/minitree,/obj/machinery/light/invisible{dir = 4},/turf/simulated/floor/tiled/dark/monotile,/area/map_template/wreck/wreckfour)
"ba" = (/obj/machinery/beehive,/obj/structure/cable/green{d1 = 2; d2 = 8; icon_state = "2-8"},/turf/simulated/floor/grass,/area/map_template/wreck/wreckfour)
"bb" = (/obj/floor_decal/corner/b_green/border{dir = 4},/obj/machinery/seed_storage/garden{dir = 8},/obj/decal/cleanable/dirt,/turf/simulated/floor/tiled/dark/monotile,/area/map_template/wreck/wreckfour)
"bc" = (/obj/floor_decal/corner/b_green/border{dir = 8},/obj/structure/bed/chair/padded/green{dir = 1},/obj/machinery/light/invisible{dir = 8},/turf/simulated/floor/tiled/dark/monotile,/area/map_template/wreck/wreckfour)
"bd" = (/obj/floor_decal/borderfloor{dir = 4},/obj/floor_decal/spline/fancy/wood{dir = 4},/obj/machinery/atmospherics/unary/vent_pump/on,/obj/decal/cleanable/dirt,/turf/simulated/floor/tiled/dark,/area/map_template/wreck/wreckfour)
"be" = (/obj/floor_decal/spline/fancy/wood{dir = 10; icon_state = "spline_fancy"},/turf/simulated/floor/tiled/dark,/area/map_template/wreck/wreckfour)
"bf" = (/obj/floor_decal/spline/fancy/wood/corner{dir = 8},/obj/floor_decal/spline/fancy/wood{dir = 4},/obj/structure/railing/mapped{dir = 4; icon_state = "railing0-1"},/turf/simulated/floor/tiled/dark/monotile,/area/map_template/wreck/wreckfour)
"bg" = (/obj/floor_decal/spline/fancy/wood/corner,/obj/floor_decal/spline/fancy/wood{dir = 8},/obj/structure/railing/mapped{dir = 8; icon_state = "railing0-1"},/turf/simulated/floor/tiled/dark/monotile,/area/map_template/wreck/wreckfour)
"bh" = (/obj/floor_decal/spline/fancy/wood{dir = 6; icon_state = "spline_fancy"},/turf/simulated/floor/tiled/dark,/area/map_template/wreck/wreckfour)
"bi" = (/obj/floor_decal/borderfloor{dir = 8},/obj/floor_decal/spline/fancy/wood{dir = 8},/obj/machinery/atmospherics/unary/vent_scrubber/on,/turf/simulated/floor/tiled/dark,/area/map_template/wreck/wreckfour)
"bj" = (/obj/floor_decal/corner/b_green/border{dir = 4},/obj/machinery/vending/hydronutrients/generic{dir = 8},/obj/machinery/light/invisible{dir = 4},/turf/simulated/floor/tiled/dark/monotile,/area/map_template/wreck/wreckfour)
"bk" = (/obj/floor_decal/corner/b_green/border{dir = 8},/obj/structure/reagent_dispensers/watertank,/turf/simulated/floor/tiled/dark/monotile,/area/map_template/wreck/wreckfour)
"bl" = (/obj/floor_decal/borderfloor{dir = 4},/obj/floor_decal/spline/fancy/wood{dir = 4},/obj/machinery/atmospherics/pipe/simple/hidden/supply,/turf/simulated/floor/tiled/dark,/area/map_template/wreck/wreckfour)
"bm" = (/obj/structure/foamedmetal,/turf/template_noop,/area/template_noop)
"bn" = (/obj/floor_decal/spline/fancy/wood{dir = 10; icon_state = "spline_fancy"},/obj/floor_decal/spline/fancy/wood/corner{dir = 1},/turf/simulated/floor/tiled/dark/monotile,/area/map_template/wreck/wreckfour)
"bo" = (/obj/floor_decal/spline/fancy/wood/corner{dir = 8},/obj/floor_decal/spline/fancy/wood{dir = 1; icon_state = "spline_fancy"},/obj/structure/railing/mapped{dir = 1; icon_state = "railing0-1"},/turf/simulated/floor/tiled/dark/monotile,/area/map_template/wreck/wreckfour)
"bp" = (/obj/floor_decal/spline/fancy/wood{dir = 1; icon_state = "spline_fancy"},/obj/structure/railing/mapped{dir = 1; icon_state = "railing0-1"},/obj/structure/disposalpipe/trunk,/obj/machinery/disposal,/turf/simulated/floor/tiled/dark/monotile,/area/map_template/wreck/wreckfour)
"bq" = (/obj/floor_decal/spline/fancy/wood/corner,/obj/floor_decal/spline/fancy/wood{dir = 1; icon_state = "spline_fancy"},/obj/structure/railing/mapped{dir = 1; icon_state = "railing0-1"},/turf/simulated/floor/tiled/dark/monotile,/area/map_template/wreck/wreckfour)
"br" = (/obj/floor_decal/spline/fancy/wood{dir = 6; icon_state = "spline_fancy"},/obj/floor_decal/spline/fancy/wood/corner{dir = 4},/turf/simulated/floor/tiled/dark/monotile,/area/map_template/wreck/wreckfour)
"bs" = (/obj/floor_decal/borderfloor{dir = 8},/obj/floor_decal/spline/fancy/wood{dir = 8},/obj/machinery/atmospherics/pipe/simple/hidden/scrubbers,/obj/decal/cleanable/dirt,/turf/simulated/floor/tiled/dark,/area/map_template/wreck/wreckfour)
"bt" = (/obj/floor_decal/borderfloor{dir = 4},/obj/floor_decal/spline/fancy/wood{dir = 4},/obj/structure/closet/crate/large,/obj/random/junkyard/loot,/obj/random/junkyard/loot,/obj/random/junkyard/loot,/obj/random/junkyard/loot,/obj/random/junkyard/loot,/obj/machinery/atmospherics/pipe/simple/hidden/supply,/obj/decal/cleanable/dirt,/turf/simulated/floor/tiled/dark,/area/map_template/wreck/wreckfour)
"bu" = (/obj/floor_decal/spline/fancy/wood/corner,/obj/floor_decal/spline/fancy/wood/corner{dir = 8},/obj/structure/disposalpipe/segment,/obj/machinery/light/invisible,/obj/machinery/hologram/holopad,/turf/simulated/floor/tiled/dark/monotile,/area/map_template/wreck/wreckfour)
"bv" = (/obj/floor_decal/borderfloor/corner{dir = 4},/obj/floor_decal/spline/fancy/wood/corner{dir = 1},/obj/structure/closet/crate/freezer/rations,/obj/machinery/atmospherics/pipe/simple/hidden/supply{dir = 5},/turf/simulated/floor/tiled/dark,/area/map_template/wreck/wreckfour)
"bw" = (/obj/floor_decal/borderfloor{dir = 5},/obj/floor_decal/spline/fancy/wood{dir = 5; icon_state = "spline_fancy"},/obj/machinery/atmospherics/pipe/simple/hidden/supply{dir = 10},/turf/simulated/floor/tiled/dark,/area/map_template/wreck/wreckfour)
"bx" = (/obj/floor_decal/spline/fancy/wood{dir = 8},/obj/floor_decal/spline/fancy/wood{dir = 4},/obj/structure/disposalpipe/segment,/obj/machinery/light/invisible{dir = 1},/turf/simulated/floor/tiled/dark,/area/map_template/wreck/wreckfour)
"by" = (/obj/floor_decal/borderfloor{dir = 9},/obj/floor_decal/spline/fancy/wood{dir = 9; icon_state = "spline_fancy"},/obj/machinery/atmospherics/pipe/simple/hidden/scrubbers{dir = 6},/obj/decal/cleanable/dirt,/turf/simulated/floor/tiled/dark,/area/map_template/wreck/wreckfour)
"bz" = (/obj/floor_decal/borderfloor/corner{dir = 1},/obj/floor_decal/spline/fancy/wood/corner{dir = 4},/obj/machinery/atmospherics/pipe/simple/hidden/scrubbers{dir = 9},/turf/simulated/floor/tiled/dark,/area/map_template/wreck/wreckfour)
"bA" = (/obj/floor_decal/borderfloor/corner{dir = 4},/obj/floor_decal/spline/fancy/wood/corner{dir = 1},/obj/machinery/light,/obj/machinery/atmospherics/pipe/simple/hidden/supply{dir = 5},/turf/simulated/floor/tiled/dark,/area/map_template/wreck/wreckfour)
"bB" = (/obj/floor_decal/spline/fancy/wood{dir = 8},/obj/floor_decal/spline/fancy/wood{dir = 4},/obj/structure/disposalpipe/segment,/turf/simulated/floor/tiled/dark,/area/map_template/wreck/wreckfour)
"bC" = (/obj/floor_decal/borderfloor/corner{dir = 1},/obj/floor_decal/spline/fancy/wood/corner{dir = 4},/obj/machinery/light,/obj/machinery/atmospherics/pipe/simple/hidden/scrubbers{dir = 9},/obj/decal/cleanable/dirt,/turf/simulated/floor/tiled/dark,/area/map_template/wreck/wreckfour)
"bD" = (/obj/floor_decal/borderfloor/corner{dir = 4},/obj/floor_decal/spline/fancy/wood/corner{dir = 1},/obj/structure/closet/crate/plastic,/obj/random/junkyard/tech_supply,/obj/random/junkyard/tech_supply,/obj/random/junkyard/tech_supply,/obj/random/junkyard/tech_supply,/obj/machinery/atmospherics/pipe/simple/hidden/supply{dir = 5},/turf/simulated/floor/tiled/dark,/area/map_template/wreck/wreckfour)
"bE" = (/obj/floor_decal/borderfloor{dir = 5},/obj/floor_decal/spline/fancy/wood{dir = 5; icon_state = "spline_fancy"},/obj/machinery/atmospherics/pipe/simple/hidden/supply{dir = 10},/obj/structure/cable/green{d1 = 2; d2 = 4; icon_state = "2-4"},/turf/simulated/floor/tiled/dark,/area/map_template/wreck/wreckfour)
"bF" = (/obj/machinery/portable_atmospherics/hydroponics/soil,/obj/item/clothing/head/helmet/space/void/engineering/salvage,/turf/simulated/floor/grass,/area/map_template/wreck/wreckfour)
"bG" = (/obj/machinery/power/port_gen/pacman{anchored = 0; sheets = 25},/obj/structure/cable/green{d2 = 8; icon_state = "0-8"},/turf/simulated/floor/grass,/area/map_template/wreck/wreckfour)
"bH" = (/obj/floor_decal/borderfloor/corner{dir = 1},/obj/floor_decal/spline/fancy/wood/corner{dir = 4},/obj/machinery/firealarm{dir = 4; pixel_x = 24},/obj/machinery/atmospherics/pipe/simple/hidden/scrubbers{dir = 9},/turf/simulated/floor/tiled/dark,/area/map_template/wreck/wreckfour)
"bI" = (/obj/floor_decal/borderfloor/corner{dir = 4},/obj/floor_decal/spline/fancy/wood/corner{dir = 1},/obj/structure/cable{d2 = 4; icon_state = "0-4"},/obj/machinery/power/apc/derelict{dir = 8; pixel_x = -20},/obj/machinery/light,/obj/machinery/atmospherics/pipe/simple/hidden/supply{dir = 5},/obj/structure/cable/green,/turf/simulated/floor/tiled/dark,/area/map_template/wreck/wreckfour)
"bJ" = (/obj/floor_decal/borderfloor{dir = 5},/obj/floor_decal/spline/fancy/wood{dir = 5; icon_state = "spline_fancy"},/obj/structure/cable{d1 = 2; d2 = 8; desc = "A flexible superconducting cable for heavy-duty power transfer. It's been labeled 'chaos reigns'."; icon_state = "2-8"},/obj/machinery/atmospherics/pipe/simple/hidden/supply{dir = 10},/obj/structure/cable/green{d1 = 1; d2 = 4; icon_state = "1-4"},/turf/simulated/floor/tiled/dark,/area/map_template/wreck/wreckfour)
"bK" = (/obj/structure/closet/crate/secure/loot,/turf/simulated/floor/plating,/area/template_noop)
"bL" = (/obj/floor_decal/spline/fancy/wood{dir = 8},/obj/floor_decal/spline/fancy/wood{dir = 4},/obj/structure/disposalpipe/segment,/obj/item/clothing/suit/space/void/engineering/salvage,/turf/simulated/floor/tiled/dark,/area/map_template/wreck/wreckfour)
"bM" = (/obj/floor_decal/borderfloor/corner{dir = 4},/obj/floor_decal/spline/fancy/wood/corner{dir = 1},/obj/structure/cable{d1 = 1; d2 = 4; icon_state = "1-4"},/obj/machinery/light,/obj/machinery/atmospherics/pipe/simple/hidden/supply{dir = 5},/turf/simulated/floor/tiled/dark,/area/map_template/wreck/wreckfour)
"bN" = (/obj/floor_decal/borderfloor{dir = 1},/obj/floor_decal/spline/fancy/wood{dir = 1; icon_state = "spline_fancy"},/obj/structure/cable{d1 = 4; d2 = 8; icon_state = "4-8"},/obj/machinery/atmospherics/pipe/simple/hidden/supply{dir = 4},/obj/machinery/alarm{dir = 1; pixel_y = -25},/turf/simulated/floor/tiled/dark,/area/map_template/wreck/wreckfour)
"bO" = (/obj/floor_decal/borderfloor{dir = 1},/obj/floor_decal/spline/fancy/wood{dir = 1; icon_state = "spline_fancy"},/obj/structure/inflatable/wall,/obj/structure/cable{d1 = 4; d2 = 8; icon_state = "4-8"},/obj/machinery/atmospherics/pipe/simple/hidden/supply{dir = 4},/turf/simulated/floor/tiled/dark,/area/map_template/wreck/wreckfour)
"bP" = (/obj/floor_decal/spline/fancy/wood/corner{dir = 1},/obj/floor_decal/spline/fancy/wood/corner{dir = 4},/obj/structure/inflatable/door,/obj/structure/disposalpipe/segment,/obj/structure/cable{d1 = 2; d2 = 8; desc = "A flexible superconducting cable for heavy-duty power transfer. It's been labeled 'chaos reigns'."; icon_state = "2-8"},/obj/machinery/atmospherics/pipe/simple/hidden/supply{dir = 10},/obj/machinery/atmospherics/pipe/simple/hidden/scrubbers{dir = 6},/turf/simulated/floor/tiled/dark,/area/map_template/wreck/wreckfour)
"bQ" = (/obj/floor_decal/borderfloor{dir = 1},/obj/floor_decal/spline/fancy/wood{dir = 1; icon_state = "spline_fancy"},/obj/structure/inflatable/wall,/obj/machinery/atmospherics/pipe/simple/hidden/scrubbers{dir = 4},/turf/simulated/floor/tiled/dark,/area/map_template/wreck/wreckfour)
"bR" = (/obj/floor_decal/borderfloor{dir = 1},/obj/floor_decal/spline/fancy/wood{dir = 1; icon_state = "spline_fancy"},/obj/machinery/atmospherics/pipe/simple/hidden/scrubbers{dir = 4},/turf/simulated/floor/tiled/dark,/area/map_template/wreck/wreckfour)
"bS" = (/obj/structure/disposalpipe/segment,/obj/structure/cable{d1 = 1; d2 = 2; icon_state = "1-2"},/obj/machinery/door/airlock/hatch/maintenance/bolted,/obj/machinery/atmospherics/pipe/simple/hidden/scrubbers,/obj/machinery/atmospherics/pipe/simple/hidden/supply,/turf/simulated/floor/tiled/dark,/area/map_template/wreck/wreckfour)
"bT" = (/turf/simulated/floor/steel_dirty,/area/map_template/wreck/wreckfour)
"bU" = (/obj/structure/inflatable/door,/obj/structure/disposalpipe/segment,/obj/structure/cable{d1 = 1; d2 = 2; icon_state = "1-2"},/obj/machinery/atmospherics/pipe/simple/hidden/scrubbers,/obj/machinery/atmospherics/pipe/simple/hidden/supply,/turf/simulated/floor/steel_dirty,/area/map_template/wreck/wreckfour)
"bV" = (/obj/structure/inflatable/wall,/turf/simulated/floor/plating,/area/map_template/wreck/wreckfour)
"bW" = (/obj/structure/inflatable/wall,/turf/simulated/floor/steel_dirty,/area/map_template/wreck/wreckfour)
"bX" = (/obj/structure/lattice,/obj/structure/disposalpipe/segment,/obj/structure/cable{d1 = 1; d2 = 2; icon_state = "1-2"},/obj/machinery/atmospherics/pipe/simple/hidden/scrubbers,/obj/machinery/atmospherics/pipe/simple/hidden/supply,/turf/template_noop,/area/map_template/wreck/wreckfour)
"fE" = (/obj/structure/lattice,/obj/structure/girder/displaced,/turf/template_noop,/area/template_noop)
"hd" = (/obj/structure/grille/broken,/turf/simulated/floor/plating,/area/template_noop)
"hI" = (/obj/random/junkyard/obstruction,/turf/simulated/floor/steel_dirty,/area/template_noop)
"oB" = (/obj/decal/cleanable/dirt,/turf/simulated/floor/plating,/area/template_noop)
"pz" = (/obj/structure/catwalk,/obj/random/junkyard/hostile,/turf/simulated/floor/plating,/area/template_noop)
"qV" = (/turf/simulated/floor/plating,/area/template_noop)
"ru" = (/obj/machinery/atmospherics/pipe/simple/hidden/scrubbers,/turf/template_noop,/area/template_noop)
"uj" = (/obj/structure/disposalpipe/segment,/obj/structure/cable{d1 = 1; d2 = 2; icon_state = "1-2"},/obj/machinery/atmospherics/pipe/simple/hidden/supply,/obj/machinery/atmospherics/pipe/simple/hidden/scrubbers,/turf/simulated/floor/steel_dirty,/area/template_noop)
"uH" = (/obj/structure/catwalk,/turf/simulated/floor/plating,/area/template_noop)
"vk" = (/obj/structure/grille,/turf/simulated/floor/plating,/area/template_noop)
"wx" = (/obj/floor_decal/borderfloor{dir = 6},/obj/floor_decal/spline/fancy/wood{dir = 6; icon_state = "spline_fancy"},/turf/simulated/floor/tiled/dark,/area/map_template/wreck/wreckfour)
"BM" = (/obj/floor_decal/corner/b_green/border{dir = 4},/obj/structure/closet/crate/hydroponics/beekeeping,/obj/decal/cleanable/dirt,/obj/decal/cleanable/dirt,/turf/simulated/floor/tiled/dark/monotile,/area/map_template/wreck/wreckfour)
"BW" = (/obj/random/junkyard/hostile,/turf/simulated/floor/tiled/techmaint,/area/template_noop)
"CM" = (/obj/structure/lattice,/obj/machinery/atmospherics/pipe/simple/hidden/scrubbers,/turf/template_noop,/area/template_noop)
"DT" = (/obj/random/junkyard/hostile,/turf/simulated/floor/steel_dirty,/area/template_noop)
"EO" = (/obj/structure/girder/displaced,/turf/template_noop,/area/template_noop)
"Fi" = (/obj/structure/dispenser/oxygen,/obj/decal/cleanable/dirt,/turf/simulated/floor/tiled/techmaint,/area/template_noop)
"Fk" = (/obj/decal/cleanable/dirt,/obj/decal/cleanable/dirt,/turf/simulated/wall,/area/template_noop)
"FU" = (/turf/template_noop,/area/template_noop)
"Gp" = (/obj/decal/cleanable/dirt,/turf/simulated/wall,/area/template_noop)
"Gy" = (/obj/floor_decal/borderfloor{dir = 10},/obj/floor_decal/spline/fancy/wood{dir = 10; icon_state = "spline_fancy"},/obj/decal/cleanable/dirt,/turf/simulated/floor/tiled/dark,/area/map_template/wreck/wreckfour)
"GX" = (/obj/paint/green,/obj/decal/cleanable/dirt,/turf/simulated/wall,/area/template_noop)
"In" = (/obj/floor_decal/borderfloor{dir = 8},/obj/floor_decal/spline/fancy/wood{dir = 8},/obj/decal/cleanable/dirt,/turf/simulated/floor/tiled/dark,/area/map_template/wreck/wreckfour)
"IN" = (/obj/wallframe_spawn/reinforced,/obj/paint/green,/obj/decal/cleanable/dirt,/turf/simulated/floor/plating,/area/map_template/wreck/wreckfour)
"Jd" = (/obj/structure/lattice,/obj/random/junkyard/obstruction,/turf/template_noop,/area/template_noop)
"Jg" = (/obj/structure/foamedmetal,/obj/structure/disposalpipe/segment,/obj/structure/cable{d1 = 1; d2 = 2; icon_state = "1-2"},/obj/machinery/atmospherics/pipe/simple/hidden/supply,/obj/machinery/atmospherics/pipe/simple/hidden/scrubbers,/turf/simulated/floor/plating,/area/template_noop)
"Kp" = (/obj/structure/lattice,/turf/template_noop,/area/template_noop)
"KB" = (/turf/simulated/wall,/area/template_noop)
"KO" = (/obj/paint/green,/turf/simulated/wall,/area/template_noop)
"LL" = (/obj/floor_decal/borderfloor/corner{dir = 1},/obj/floor_decal/spline/fancy/wood/corner{dir = 4},/obj/machinery/light,/obj/machinery/atmospherics/pipe/simple/hidden/scrubbers{dir = 9},/turf/simulated/floor/tiled/dark,/area/map_template/wreck/wreckfour)
"NF" = (/turf/simulated/floor/tiled/techfloor/grid,/area/template_noop)
"Pt" = (/obj/random/junkyard/obstruction,/turf/template_noop,/area/template_noop)
"PE" = (/obj/floor_decal/borderfloor{dir = 4},/obj/floor_decal/spline/fancy/wood{dir = 4},/turf/simulated/floor/tiled/dark,/area/map_template/wreck/wreckfour)
"SF" = (/obj/structure/girder,/turf/template_noop,/area/template_noop)
"Ts" = (/obj/floor_decal/borderfloor{dir = 9},/obj/floor_decal/spline/fancy/wood{dir = 9; icon_state = "spline_fancy"},/obj/machinery/atmospherics/pipe/simple/hidden/scrubbers{dir = 6},/turf/simulated/floor/tiled/dark,/area/map_template/wreck/wreckfour)
"WU" = (/obj/structure/girder,/turf/simulated/floor/plating,/area/template_noop)
"YX" = (/obj/structure/foamedmetal,/turf/simulated/floor/steel_dirty,/area/template_noop)
"Zz" = (/obj/structure/disposalpipe/segment,/obj/machinery/atmospherics/pipe/simple/hidden/supply,/turf/template_noop,/area/template_noop)
"ZO" = (/turf/simulated/floor/tiled/techmaint,/area/template_noop)

(1,1,1) = {"
FUFUFUFUFUFUFUFUFUFUFUFUFUFUFUFUFUFUFUFUFUFUFUFUFUFUKpFUFUFU
FUFUFUFUFUFUFUFUFUFUFUFUFUFUPtFUFUFUFUFUFUFUFUFUSFKBKpFUFUFU
FUFUFUFUFUFUFUFUFUFUFUEOFUFUFUFUFUFUFUFUFUFUFUFUFUZOGpFUFUFU
FUFUFUFUFUKOKOFUFUFUFUaaabababababababaaFUFUKpfEKpoBKBKBqVKp
FUFUFUFUPtKOKOFUFUFUaaaaacadaeafagahaiaaaaFUFUKpZOFiKBBWFUFU
FUFUFUFUFUFUFUFUFUaaaaajakakakalakamakanaaaaFUFUFUGpFkKpFUFU
FUFUFUFUFUFUFUFUaaaaaoapawawawarawawawatauaaaaFUFUFUKpKpFUFU
FUFUFUFUFUFUFUababavwxawayayawaxawazazawGyaAababFUFUFUFUFUFU
FUFUFUFUFUFUFUabaBwxawawawawaCaDaEawawawawGyaFabFUFUFUFUFUFU
FUFUEOFUFUFUababaGawayayawaIaJaHaLaMawazazawaNababFUFUFUFUFU
FUFUFUFUFUFUabaOPEawawawaCaPaQaqaQaRaEawawawInaSabFUFUSFFUKO
FUFUFUFUFUFUabaTPEayayaKaVaWasaXaqaYaZaUazazaNbbabFUFUKpKpKO
FUFUFUFUFUFUabbcbdawawawbebfaQaQasbgbhawawawbibjabFUFUFUKpKp
FUFUFUFUFUFUabbkblawayayawbnbobpbqbrawazazawbsBMabFUFUKBJdFU
FUFUFUFUFUFUababbtawawawawawbebubhawawawawawbsINabFUFUKBKBKB
FUFUFUFUFUFUFUabbvbwawawayayawbxawazazawawbybzabFUFUFUFUFUFU
FUFUFUFUFUFUFUababbAbwawawawawbBawawawawbybCababFUFUFUFUFUFU
FUFUFUKpFUFUFUFUaaaabDbEbaayawbBawbFazTsbHaaaaFUFUFUFUFUFUFU
FUFUFUKpbmFUFUFUFUaaaabIbJbGawbLawawTsLLaaaaFUFUFUFUFUFUFUFU
FUFUKOpzKOFUFUFUFUFUaaaabMbNbObPbQbRbCaaaaFUFUFUFUFUFUPtFUFU
FUFUGXuHKOKOKOFUFUFUFUaaaaaaaabSaaaaaaaaFUFUFUFUFUFUFUFUFUFU
FUFUKOuHbKKpKOFUFUFUFUFUFUaabTbUbVaaFUFUFUFUFUFUFUFUFUFUFUFU
FUFUKOGXGXKpWUKpFUFUFUFUFUaabWbXFUbTFUFUFUFUFUFUFUKBKBKBKBFU
FUFUFUFUGXuHbmFUFUFUFUFUFUFUFUCMFUKpFUFUFUFUFUFUJdKBNFNFKBFU
FUFUFUFUKpuHKOFUFUFUFUFUFUbmFUruKBFUFUFUFUFUFUFUFUFUKpqVKBFU
FUFUFUFUfEFUFUFUFUFUFUFUFUKOKpFUFUWUFUFUFUFUFUFUFUFUfEFUFUFU
FUFUFUFUFUFUFUFUFUFUFUFUFUKODTFUFUKOFUFUFUFUFUFUFUFUFUFUFUFU
PtFUFUFUFUFUFUFUFUFUFUFUFUvkFUZzYXKOFUFUFUFUFUFUFUFUFUFUFUFU
KBFUFUFUFUFUFUFUFUFUFUKpKphdKpujYXKOFUFUFUFUFUFUFUFUFUFUFUFU
FUFUFUFUFUFUFUFUFUFUFUFUFUFUKpJghIKOFUFUFUFUFUFUFUFUFUFUFUFU
"}
