"aV" = (/obj/structure/railing/mapped,/obj/structure/railing/mapped{dir = 8; icon_state = "railing0-1"},/obj/machinery/porta_turret/ballistic/shotgun,/turf/simulated/floor/reinforced{map_airless = 1; name = "vacuum reinforced floor"},/area/map_template/wreck/wreck7)
"bb" = (/obj/structure/lattice,/turf/template_noop,/area/template_noop)
"bq" = (/obj/floor_decal/industrial/outline/yellow,/obj/structure/closet/crate/freezer/meat,/obj/random/maintenance,/obj/decal/cleanable/dirt,/turf/simulated/floor/tiled/techfloor/grid{initial_gas = null},/area/map_template/wreck/wreck7)
"cj" = (/obj/floor_decal/industrial/outline/yellow,/obj/machinery/botany/editor,/turf/simulated/floor/tiled/techfloor/grid{initial_gas = null},/area/map_template/wreck/wreck7)
"do" = (/obj/floor_decal/industrial/outline/yellow,/obj/machinery/power/apc/hyper{pixel_y = -24},/obj/structure/cable/green,/turf/simulated/floor/tiled/techfloor/grid{initial_gas = null},/area/map_template/wreck/wreck7)
"el" = (/turf/template_noop,/area/template_noop)
"fw" = (/obj/structure/railing/mapped{dir = 4; icon_state = "railing0-1"},/obj/structure/railing/mapped,/obj/machinery/porta_turret/ballistic/shotgun,/turf/simulated/floor/reinforced{map_airless = 1; name = "vacuum reinforced floor"},/area/map_template/wreck/wreck7)
"fy" = (/obj/floor_decal/techfloor/orange,/obj/structure/railing/mapped,/obj/decal/cleanable/dirt,/turf/simulated/floor/tiled/techfloor/grid{initial_gas = null},/area/map_template/wreck/wreck7)
"gg" = (/obj/decal/cleanable/dirt,/turf/simulated/floor/airless,/area/map_template/wreck/wreck7)
"hk" = (/obj/floor_decal/industrial/outline/yellow,/obj/structure/closet/crate/large/hydroponics,/obj/random/maintenance,/obj/random/maintenance,/obj/random/maintenance,/obj/random/maintenance,/obj/random/maintenance,/obj/random/masks,/obj/item/disk/botany,/obj/item/clothing/gloves/thick/botany,/obj/item/clothing/mask/bandana/botany,/turf/simulated/floor/tiled/techfloor/grid{initial_gas = null},/area/map_template/wreck/wreck7)
"ie" = (/obj/structure/sign/gml,/obj/paint/black,/turf/simulated/wall/iron,/area/map_template/wreck/wreck7)
"iC" = (/obj/structure/lattice,/obj/item/stack/material/iron,/turf/template_noop,/area/map_template/wreck/wreck7)
"kU" = (/obj/floor_decal/industrial/outline/yellow,/obj/machinery/portable_atmospherics/canister/oxygen/prechilled,/turf/simulated/floor/tiled/techfloor/grid{initial_gas = null},/area/map_template/wreck/wreck7)
"lg" = (/obj/floor_decal/techfloor/orange{dir = 1},/obj/structure/railing/mapped{dir = 1; icon_state = "railing0-1"},/obj/floor_decal/industrial/outline/yellow,/obj/decal/cleanable/dirt,/obj/machinery/power/smes/buildable/max_cap_in_out,/obj/structure/cable/green{d2 = 2; icon_state = "0-2"},/turf/simulated/floor/tiled/techfloor/grid{initial_gas = null},/area/map_template/wreck/wreck7)
"lj" = (/obj/floor_decal/techfloor/orange{dir = 5},/obj/structure/railing/mapped{dir = 1; icon_state = "railing0-1"},/obj/structure/railing/mapped{dir = 4; icon_state = "railing0-1"},/obj/decal/cleanable/dirt,/turf/simulated/floor/tiled/techfloor/grid{initial_gas = null},/area/map_template/wreck/wreck7)
"ls" = (/obj/floor_decal/techfloor/orange{dir = 8},/obj/decal/cleanable/dirt,/turf/simulated/floor/tiled/techfloor/grid{initial_gas = null},/area/map_template/wreck/wreck7)
"lN" = (/obj/floor_decal/techfloor/orange{dir = 9},/obj/structure/railing/mapped{dir = 1; icon_state = "railing0-1"},/obj/structure/railing/mapped{dir = 8; icon_state = "railing0-1"},/obj/floor_decal/industrial/outline/yellow,/obj/decal/cleanable/dirt,/obj/machinery/constructable_frame/computerframe/deconstruct,/turf/simulated/floor/tiled/techfloor/grid{initial_gas = null},/area/map_template/wreck/wreck7)
"ml" = (/obj/floor_decal/industrial/outline/yellow,/obj/random/junkyard/tool,/obj/random/junkyard/tool,/obj/random/junkyard/tool,/obj/random/junkyard/tool,/obj/random/junkyard/tool,/obj/structure/table/rack,/turf/simulated/floor/tiled/techfloor/grid{initial_gas = null},/area/map_template/wreck/wreck7)
"my" = (/obj/structure/catwalk,/obj/machinery/light{dir = 1},/turf/simulated/floor/airless,/area/map_template/wreck/wreck7)
"ni" = (/obj/structure/closet/crate/paper_refill,/turf/simulated/floor/airless,/area/map_template/wreck/wreck7)
"nl" = (/obj/paint/black,/turf/simulated/wall/iron,/area/map_template/wreck/wreck7)
"np" = (/obj/item/stack/material/rods,/obj/item/stack/material/rods,/obj/structure/lattice,/turf/template_noop,/area/map_template/wreck/wreck7)
"pq" = (/obj/floor_decal/industrial/outline/yellow,/obj/random/junkyard/medical/lite,/obj/structure/table/rack,/turf/simulated/floor/tiled/techfloor/grid{initial_gas = null},/area/map_template/wreck/wreck7)
"pr" = (/obj/random/junk,/turf/simulated/floor/airless,/area/map_template/wreck/wreck7)
"pQ" = (/obj/floor_decal/techfloor/orange{dir = 1},/obj/structure/railing/mapped{dir = 1; icon_state = "railing0-1"},/obj/decal/cleanable/dirt,/turf/simulated/floor/tiled/techfloor/grid{initial_gas = null},/area/map_template/wreck/wreck7)
"qi" = (/obj/floor_decal/techfloor/orange,/obj/item/stack/material/rods,/turf/simulated/floor/tiled/techfloor/grid{initial_gas = null},/area/map_template/wreck/wreck7)
"ql" = (/obj/floor_decal/techfloor/orange{dir = 9},/obj/structure/railing/mapped{dir = 1; icon_state = "railing0-1"},/obj/structure/railing/mapped{dir = 8; icon_state = "railing0-1"},/turf/simulated/floor/tiled/techfloor/grid{initial_gas = null},/area/map_template/wreck/wreck7)
"qU" = (/obj/structure/catwalk,/obj/structure/railing/mapped{dir = 4; icon_state = "railing0-1"},/turf/template_noop,/area/template_noop)
"rB" = (/obj/random/junk,/obj/decal/cleanable/dirt,/turf/simulated/floor/airless,/area/map_template/wreck/wreck7)
"uc" = (/turf/simulated/floor/airless,/area/map_template/wreck/wreck7)
"uv" = (/obj/floor_decal/industrial/outline/yellow,/obj/machinery/microwave,/obj/structure/table/standard,/obj/decal/cleanable/dirt,/turf/simulated/floor/tiled/techfloor/grid{initial_gas = null},/area/map_template/wreck/wreck7)
"uz" = (/obj/structure/catwalk,/obj/structure/railing/mapped,/turf/template_noop,/area/template_noop)
"uC" = (/obj/floor_decal/industrial/outline/yellow,/obj/machinery/portable_atmospherics/canister/nitrogen/prechilled,/obj/decal/cleanable/dirt,/obj/machinery/turretid{check_access = 0; check_records = 0; check_synth = 1; enabled = 1; pixel_y = 31},/turf/simulated/floor/tiled/techfloor/grid{initial_gas = null},/area/map_template/wreck/wreck7)
"vA" = (/obj/floor_decal/techfloor/orange,/obj/decal/cleanable/dirt,/turf/simulated/floor/tiled/techfloor/grid{initial_gas = null},/area/map_template/wreck/wreck7)
"zt" = (/obj/floor_decal/techfloor/orange{dir = 10},/obj/structure/railing/mapped,/obj/structure/railing/mapped{dir = 8; icon_state = "railing0-1"},/obj/floor_decal/industrial/outline/yellow,/obj/random/drinkbottle,/obj/random/drinkbottle,/obj/random/drinkbottle,/obj/random/drinkbottle,/obj/random/drinkbottle,/obj/structure/closet/crate/plastic,/obj/decal/cleanable/dirt,/turf/simulated/floor/tiled/techfloor/grid{initial_gas = null},/area/map_template/wreck/wreck7)
"zB" = (/obj/structure/catwalk,/obj/machinery/light,/turf/simulated/floor/airless,/area/map_template/wreck/wreck7)
"zS" = (/obj/random/maintenance,/obj/random/maintenance,/turf/simulated/floor/airless,/area/map_template/wreck/wreck7)
"AT" = (/obj/floor_decal/industrial/outline/yellow,/obj/structure/table/standard,/obj/random/junkyard/powercell,/turf/simulated/floor/tiled/techfloor/grid{initial_gas = null},/area/map_template/wreck/wreck7)
"Du" = (/obj/structure/catwalk,/turf/simulated/floor/airless,/area/map_template/wreck/wreck7)
"Dz" = (/obj/machinery/door/airlock/vault/bolted,/obj/floor_decal/industrial/warning{dir = 8},/turf/simulated/floor/tiled/techfloor/grid{initial_gas = null},/area/map_template/wreck/wreck7)
"DC" = (/obj/floor_decal/industrial/outline/yellow,/obj/machinery/papershredder,/obj/decal/cleanable/dirt,/turf/simulated/floor/tiled/techfloor/grid{initial_gas = null},/area/map_template/wreck/wreck7)
"DL" = (/obj/floor_decal/industrial/outline/yellow,/obj/machinery/portable_atmospherics/hydroponics{anchored = 0},/obj/decal/cleanable/dirt,/turf/simulated/floor/tiled/techfloor/grid{initial_gas = null},/area/map_template/wreck/wreck7)
"Ek" = (/obj/floor_decal/industrial/outline/yellow,/obj/machinery/pipedispenser,/turf/simulated/floor/tiled/techfloor/grid{initial_gas = null},/area/map_template/wreck/wreck7)
"Eo" = (/obj/machinery/portable_atmospherics/powered/scrubber,/obj/floor_decal/techfloor/orange{dir = 4},/obj/decal/cleanable/dirt,/turf/simulated/floor/tiled/techfloor/grid{initial_gas = null},/area/map_template/wreck/wreck7)
"EX" = (/obj/item/stack/material/rods,/turf/simulated/floor/airless,/area/map_template/wreck/wreck7)
"FA" = (/obj/structure/catwalk,/obj/structure/railing/mapped{dir = 8; icon_state = "railing0-1"},/turf/template_noop,/area/template_noop)
"Gd" = (/obj/structure/catwalk,/obj/structure/railing/mapped{dir = 1; icon_state = "railing0-1"},/turf/template_noop,/area/template_noop)
"Gi" = (/obj/floor_decal/industrial/outline/yellow,/obj/random/maintenance,/obj/random/maintenance,/obj/structure/table/rack,/obj/decal/cleanable/dirt,/turf/simulated/floor/tiled/techfloor/grid{initial_gas = null},/area/map_template/wreck/wreck7)
"Gn" = (/obj/floor_decal/industrial/outline/yellow,/obj/random/junkyard/toolbox,/obj/structure/table/rack,/turf/simulated/floor/tiled/techfloor/grid{initial_gas = null},/area/map_template/wreck/wreck7)
"Gv" = (/obj/floor_decal/techfloor/orange{dir = 6},/obj/structure/railing/mapped,/obj/structure/railing/mapped{dir = 4; icon_state = "railing0-1"},/obj/floor_decal/industrial/outline/yellow,/obj/decal/cleanable/dirt,/turf/simulated/floor/tiled/techfloor/grid{initial_gas = null},/area/map_template/wreck/wreck7)
"GC" = (/obj/floor_decal/techfloor/orange{dir = 10},/obj/structure/railing/mapped,/obj/structure/railing/mapped{dir = 8; icon_state = "railing0-1"},/obj/decal/cleanable/dirt,/turf/simulated/floor/tiled/techfloor/grid{initial_gas = null},/area/map_template/wreck/wreck7)
"GJ" = (/turf/template_noop,/area/map_template/wreck/wreck7)
"IY" = (/obj/floor_decal/industrial/outline/yellow,/obj/structure/closet/crate/paper_refill,/obj/decal/cleanable/dirt,/turf/simulated/floor/tiled/techfloor/grid{initial_gas = null},/area/map_template/wreck/wreck7)
"Ji" = (/obj/floor_decal/techfloor/orange{dir = 1},/obj/structure/railing/mapped{dir = 1; icon_state = "railing0-1"},/turf/simulated/floor/tiled/techfloor/grid{initial_gas = null},/area/map_template/wreck/wreck7)
"JI" = (/obj/floor_decal/industrial/outline/yellow,/obj/machinery/portable_atmospherics/canister/oxygen/prechilled,/obj/decal/cleanable/dirt,/turf/simulated/floor/tiled/techfloor/grid{initial_gas = null},/area/map_template/wreck/wreck7)
"JZ" = (/obj/floor_decal/industrial/outline/yellow,/turf/simulated/floor/tiled/techfloor/grid{initial_gas = null},/area/map_template/wreck/wreck7)
"Le" = (/obj/floor_decal/industrial/outline/yellow,/obj/decal/cleanable/dirt,/turf/simulated/floor/tiled/techfloor/grid{initial_gas = null},/area/map_template/wreck/wreck7)
"Lt" = (/obj/floor_decal/industrial/outline/yellow,/obj/machinery/photocopier,/obj/decal/cleanable/dirt,/turf/simulated/floor/tiled/techfloor/grid{initial_gas = null},/area/map_template/wreck/wreck7)
"Ms" = (/obj/landmark/damager,/obj/paint/black,/turf/simulated/wall/iron,/area/map_template/wreck/wreck7)
"NF" = (/obj/machinery/door/airlock/vault/bolted,/obj/floor_decal/industrial/warning{dir = 4},/turf/simulated/floor/tiled/techfloor/grid{initial_gas = null},/area/map_template/wreck/wreck7)
"Pg" = (/obj/structure/catwalk,/obj/decal/cleanable/dirt,/turf/simulated/floor/airless,/area/map_template/wreck/wreck7)
"PI" = (/obj/structure/catwalk,/obj/machinery/power/terminal,/turf/simulated/floor/airless,/area/map_template/wreck/wreck7)
"PY" = (/obj/floor_decal/techfloor/orange{dir = 1},/obj/structure/railing/mapped{dir = 1; icon_state = "railing0-1"},/obj/floor_decal/industrial/outline/yellow,/obj/structure/closet/crate/medical,/obj/random/junkyard/medical,/obj/random/junkyard/medical,/obj/random/junkyard/medical,/obj/random/junkyard/medical,/obj/random/junkyard/medical/lite,/turf/simulated/floor/tiled/techfloor/grid{initial_gas = null},/area/map_template/wreck/wreck7)
"QO" = (/obj/floor_decal/techfloor/orange{dir = 8},/obj/decal/cleanable/dirt,/obj/random/junkyard/loot,/obj/structure/closet/crate/radiation,/obj/random/junkyard/loot,/obj/random/junkyard/loot,/turf/simulated/floor/tiled/techfloor/grid{initial_gas = null},/area/map_template/wreck/wreck7)
"Rz" = (/obj/item/stack/material/rods,/obj/decal/cleanable/dirt,/turf/simulated/floor/airless,/area/map_template/wreck/wreck7)
"SC" = (/obj/floor_decal/techfloor/orange,/obj/structure/railing/mapped,/obj/floor_decal/industrial/outline/yellow,/obj/structure/table/standard,/obj/random/junkyard/tech_supply,/obj/decal/cleanable/dirt,/turf/simulated/floor/tiled/techfloor/grid{initial_gas = null},/area/map_template/wreck/wreck7)
"SJ" = (/obj/structure/railing/mapped{dir = 4; icon_state = "railing0-1"},/obj/structure/railing/mapped{dir = 1; icon_state = "railing0-1"},/obj/machinery/porta_turret/ballistic/shotgun,/turf/simulated/floor/reinforced{map_airless = 1; name = "vacuum reinforced floor"},/area/map_template/wreck/wreck7)
"SN" = (/obj/structure/catwalk,/obj/machinery/light{dir = 1},/obj/decal/cleanable/dirt,/turf/simulated/floor/airless,/area/map_template/wreck/wreck7)
"TE" = (/obj/floor_decal/techfloor/orange{dir = 6},/obj/structure/railing/mapped,/obj/structure/railing/mapped{dir = 4; icon_state = "railing0-1"},/turf/simulated/floor/tiled/techfloor/grid{initial_gas = null},/area/map_template/wreck/wreck7)
"Vl" = (/obj/floor_decal/techfloor/orange{dir = 4},/obj/decal/cleanable/dirt,/turf/simulated/floor/tiled/techfloor/grid{initial_gas = null},/area/map_template/wreck/wreck7)
"VI" = (/obj/floor_decal/industrial/outline/yellow,/obj/random/junkyard/bomb_supply,/obj/random/junkyard/bomb_supply,/obj/random/junkyard/bomb_supply,/obj/structure/table/rack,/obj/decal/cleanable/dirt,/turf/simulated/floor/tiled/techfloor/grid{initial_gas = null},/area/map_template/wreck/wreck7)
"Wk" = (/obj/structure/railing/mapped{dir = 8; icon_state = "railing0-1"},/obj/structure/railing/mapped{dir = 1; icon_state = "railing0-1"},/obj/machinery/porta_turret/ballistic/shotgun,/turf/simulated/floor/reinforced{map_airless = 1; name = "vacuum reinforced floor"},/area/map_template/wreck/wreck7)
"Xr" = (/obj/structure/lattice,/turf/template_noop,/area/map_template/wreck/wreck7)
"XH" = (/obj/floor_decal/techfloor/orange{dir = 5},/obj/structure/railing/mapped{dir = 1; icon_state = "railing0-1"},/obj/structure/railing/mapped{dir = 4; icon_state = "railing0-1"},/obj/floor_decal/industrial/outline/yellow,/obj/random/junkyard/medical/lite,/obj/random/junkyard/medical/lite,/obj/decal/cleanable/dirt,/turf/simulated/floor/tiled/techfloor/grid{initial_gas = null},/area/map_template/wreck/wreck7)
"YO" = (/obj/floor_decal/techfloor/orange,/obj/machinery/portable_atmospherics/powered/pump/filled,/obj/structure/railing/mapped,/obj/floor_decal/industrial/outline/yellow,/obj/decal/cleanable/dirt,/turf/simulated/floor/tiled/techfloor/grid{initial_gas = null},/area/map_template/wreck/wreck7)
"ZJ" = (/obj/floor_decal/techfloor/orange{dir = 8},/turf/simulated/floor/tiled/techfloor/grid{initial_gas = null},/area/map_template/wreck/wreck7)

(1,1,1) = {"
WkGdGdienlMsnlnlnlnlnlMsMsnlMsnlieGdGdSJ
FAMsMsnlmyZJGiLekUATuvLeIYLtVlSNnlnlnlqU
FAMsJZEoPglsJZJIVILezSprniDCVlPglsuCnlqU
elnlYOGvDuGCfyfyvAEXGJXrqifyTEPgztSCnlbb
elDzDuDuPgPgDugguciCGJnpucPgPgPgPgPINFbb
bbnlPYXHPgqlJiRzXrGJEXJipQpQljDulNlgnlel
FAnlpqVlPgQObqrBucGnJZDLDLJZVlPglsdoMsqU
FAnlnlnlzBlsLeEkmlLeLecjhkDLVlzBnlnlnlqU
aVuzuzienlMsMsMsnlnlnlnlnlnlMsnlieuzuzfw
"}
